Source Port,Destination Port,NAT Source Port,NAT Destination Port,Action,Bytes,Bytes Sent,Bytes Received,Packets,Elapsed Time (sec),pkts_sent,pkts_received,anomaly,anomaly_reason
6881,50321,43265,50321,allow,238,118,120,2,1199,1,1,1,"High deviation in NAT Destination Port, Destination Port, Elapsed Time (sec)"
60513,47094,45469,47094,allow,320,140,180,6,7,3,3,1,"High deviation in pkts_sent, NAT Destination Port, Destination Port"
34529,443,30445,443,allow,62652,30891,31761,158,381,67,91,1,"High deviation in pkts_sent, Bytes Sent, Bytes"
59347,80,59347,80,allow,108790,4633,104157,192,15,66,126,1,"High deviation in pkts_sent, Bytes Received, Bytes"
63842,45682,31353,45682,allow,4687209,3850148,837061,4974,107,3004,1970,1,"High deviation in pkts_sent, Bytes Sent, Bytes"
52103,80,61932,80,allow,68083,5515,62568,90,38,40,50,1,"High deviation in pkts_sent, Bytes Received, Bytes"
50685,80,6959,80,allow,63891,26626,37265,86,34,39,47,1,"High deviation in pkts_sent, Bytes Sent, Bytes"
46265,443,19534,443,allow,173828,9311,164517,245,448,118,127,1,"High deviation in pkts_sent, Bytes Received, Bytes"
52715,443,38027,443,allow,164840,5975,158865,179,122,61,118,1,"High deviation in pkts_sent, Bytes Received, Bytes"
61396,443,45721,443,allow,550484,8433,542051,541,246,99,442,1,"High deviation in pkts_sent, Bytes Received, Bytes"
61273,443,55960,443,allow,19675,8597,11078,137,480,68,69,1,"High deviation in pkts_sent, Bytes Sent, Bytes"
36036,443,36036,443,allow,261234,32183,229051,326,212,153,173,1,"High deviation in pkts_sent, Bytes Received, Bytes"
57470,20220,32069,20220,allow,870,330,540,12,2308,6,6,1,"High deviation in pkts_sent, NAT Destination Port, Elapsed Time (sec)"
33856,443,15413,443,allow,8171028,105740,8065288,6637,149,745,5892,1,"High deviation in pkts_sent, Bytes Received, Bytes"
59983,443,26904,443,allow,296863,14073,282790,351,127,130,221,1,"High deviation in pkts_sent, Bytes Received, Bytes"
15503,63425,41497,63425,allow,481,150,331,2,1200,1,1,1,"High deviation in NAT Destination Port, Destination Port, Elapsed Time (sec)"
5886,80,5886,80,allow,138678,5557,133121,152,16,58,94,1,"High deviation in pkts_sent, Bytes Received, Bytes"
51221,64767,41578,64767,allow,330,330,0,6,1200,6,0,1,"High deviation in pkts_sent, NAT Destination Port, Destination Port"
56717,80,40230,80,allow,3894448,104279,3790169,4041,97,1411,2630,1,"High deviation in pkts_sent, Bytes Received, Bytes"
49359,443,64650,443,allow,63494,7222,56272,107,81,49,58,1,"High deviation in pkts_sent, Bytes Received, Bytes"
38717,443,31292,443,allow,958865,18695,940170,908,16,266,642,1,"High deviation in pkts_sent, Bytes Received, Bytes"
57138,443,59763,443,allow,70379,4205,66174,101,403,51,50,1,"High deviation in pkts_sent, Bytes Received, Bytes"
43088,5228,50878,5228,allow,4708,1753,2955,27,4133,12,15,1,"High deviation in pkts_sent, Elapsed Time (sec), NAT Destination Port"
37647,443,55661,443,allow,697381,19797,677584,725,106,247,478,1,"High deviation in pkts_sent, Bytes Received, Bytes"
65524,443,51488,443,allow,282968,9210,273758,296,15,106,190,1,"High deviation in pkts_sent, Bytes Received, Bytes"
51221,51413,17316,51413,allow,460,150,310,2,1200,1,1,1,"High deviation in NAT Destination Port, Destination Port, Elapsed Time (sec)"
65525,443,9387,443,allow,92247,4799,87448,107,15,43,64,1,"High deviation in pkts_sent, Bytes Received, Bytes"
10151,11888,57602,11888,allow,491,150,341,2,1200,1,1,1,"High deviation in NAT Destination Port, Elapsed Time (sec), Destination Port"
64093,64828,53558,64828,allow,70,70,0,1,4,1,0,1,"High deviation in NAT Destination Port, Destination Port, NAT Source Port"
54401,443,33851,443,allow,11527127,373718,11153409,12286,144,4090,8196,1,"High deviation in pkts_sent, Bytes Received, Bytes"
52486,443,26318,443,allow,57366,41661,15705,111,440,66,45,1,"High deviation in pkts_sent, Bytes Sent, Bytes"
44323,5228,8392,5228,allow,7292,4509,2783,50,6392,25,25,1,"High deviation in pkts_sent, Elapsed Time (sec), Bytes Sent"
57470,13613,53702,13613,allow,1577,594,983,20,1638,10,10,1,"High deviation in pkts_sent, NAT Destination Port, Elapsed Time (sec)"
28007,443,40494,443,allow,31586,15587,15999,213,884,105,108,1,"High deviation in pkts_sent, Bytes Sent, Bytes"
53895,443,16317,443,allow,375374,160846,214528,633,1412,294,339,1,"High deviation in pkts_sent, Bytes Sent, Bytes"
52234,64624,43132,64624,allow,136,136,0,3,14,3,0,1,"High deviation in pkts_sent, NAT Destination Port, Destination Port"
57575,443,57575,443,allow,206737,25710,181027,212,180,75,137,1,"High deviation in pkts_sent, Bytes Received, Bytes"
57573,443,57573,443,allow,775362,32338,743024,683,180,169,514,1,"High deviation in pkts_sent, Bytes Received, Bytes"
57570,443,57570,443,allow,175212,28668,146544,186,180,69,117,1,"High deviation in pkts_sent, Bytes Received, Bytes"
53527,443,25088,443,allow,127391,26326,101065,179,172,76,103,1,"High deviation in pkts_sent, Bytes Received, Bytes"
56597,443,50431,443,allow,10135129,248530,9886599,9808,64,3124,6684,1,"High deviation in pkts_sent, Bytes Received, Bytes"
64114,64126,30827,64126,allow,66,66,0,2,8,2,0,1,"High deviation in pkts_sent, NAT Destination Port, Destination Port"
53527,5228,55667,5228,allow,9674,1776,7898,29,3764,11,18,1,"High deviation in pkts_sent, Elapsed Time (sec), Bytes Received"
51152,443,11725,443,allow,44048,4441,39607,97,317,43,54,1,"High deviation in pkts_sent, Bytes Received, Bytes"
42625,443,18977,443,allow,218298,5904,212394,220,120,63,157,1,"High deviation in pkts_sent, Bytes Received, Bytes"
52102,443,62995,443,allow,343074,14649,328425,390,41,159,231,1,"High deviation in pkts_sent, Bytes Received, Bytes"
57470,21158,39017,21158,allow,2182,798,1384,19,1199,10,9,1,"High deviation in pkts_sent, NAT Destination Port, Elapsed Time (sec)"
52258,58792,14441,58792,allow,316,136,180,6,8,3,3,1,"High deviation in pkts_sent, NAT Destination Port, Destination Port"
51817,443,24496,443,allow,2811130,115323,2695807,3382,206,1445,1937,1,"High deviation in pkts_sent, Bytes Received, Bytes"
51221,49857,1668,49857,allow,791,266,525,8,1200,4,4,1,"High deviation in pkts_sent, NAT Destination Port, Destination Port"
53973,50546,28275,50546,allow,2069,1081,988,12,16,7,5,1,"High deviation in pkts_sent, NAT Destination Port, Destination Port"
64081,59517,43134,59517,allow,504,382,122,8,16,6,2,1,"High deviation in pkts_sent, NAT Destination Port, Destination Port"
52229,54711,46262,54711,allow,136,136,0,3,14,3,0,1,"High deviation in pkts_sent, NAT Destination Port, Destination Port"
52048,80,14488,80,allow,41486,20844,20642,64,37,32,32,1,"High deviation in pkts_sent, Bytes Sent, Bytes"
53176,58851,59130,58851,allow,70,70,0,2,8,2,0,1,"High deviation in pkts_sent, NAT Destination Port, Destination Port"
59949,80,40471,80,allow,730296,15564,714732,723,57,218,505,1,"High deviation in pkts_sent, Bytes Received, Bytes"
43225,443,17321,443,allow,3831584,85342,3746242,3246,110,597,2649,1,"High deviation in pkts_sent, Bytes Received, Bytes"
43227,443,35933,443,allow,1139403,49178,1090225,1155,108,353,802,1,"High deviation in pkts_sent, Bytes Received, Bytes"
50584,51413,16088,51413,allow,475,150,325,2,1200,1,1,1,"High deviation in NAT Destination Port, Destination Port, Elapsed Time (sec)"
51221,40624,20030,40624,allow,594,594,0,10,1200,10,0,1,"High deviation in pkts_sent, NAT Destination Port, Destination Port"
19473,45556,7986,45556,allow,469,150,319,2,1200,1,1,1,"High deviation in NAT Destination Port, Destination Port, Elapsed Time (sec)"
30188,12494,61043,12494,allow,502,150,352,2,1200,1,1,1,"High deviation in NAT Destination Port, Elapsed Time (sec), Destination Port"
21133,51413,43233,51413,allow,460,150,310,2,1200,1,1,1,"High deviation in NAT Destination Port, Destination Port, Elapsed Time (sec)"
49564,443,50036,443,allow,180388,3938,176450,145,161,20,125,1,"High deviation in pkts_sent, Bytes Received, Bytes"
45315,80,28283,80,allow,6087687,127446,5960241,5920,28,1981,3939,1,"High deviation in pkts_sent, Bytes Received, Bytes"
49483,7000,49483,7000,allow,755531,16955,738576,785,16,265,520,1,"High deviation in pkts_sent, Bytes Received, Bytes"
52025,80,59666,80,allow,87927,9680,78247,101,37,40,61,1,"High deviation in pkts_sent, Bytes Received, Bytes"
6881,64422,29110,64422,allow,219,111,108,2,1201,1,1,1,"High deviation in NAT Destination Port, Destination Port, Elapsed Time (sec)"
50822,443,34134,443,allow,89322,8569,80753,102,316,31,71,1,"High deviation in pkts_sent, Bytes Received, Bytes"
51263,443,47905,443,allow,143597,6963,136634,206,439,103,103,1,"High deviation in pkts_sent, Bytes Received, Bytes"
56285,443,32543,443,allow,185763,7360,178403,201,120,68,133,1,"High deviation in pkts_sent, Bytes Received, Bytes"
40074,443,9837,443,allow,412322,17503,394819,466,140,167,299,1,"High deviation in pkts_sent, Bytes Received, Bytes"
55226,443,25011,443,allow,711879,19394,692485,724,98,238,486,1,"High deviation in pkts_sent, Bytes Received, Bytes"
52101,443,56883,443,allow,5706850,104758,5602092,5170,41,1379,3791,1,"High deviation in pkts_sent, Bytes Received, Bytes"
60407,443,48240,443,allow,308771,8699,300072,322,30,112,210,1,"High deviation in pkts_sent, Bytes Received, Bytes"
53169,44707,23330,44707,allow,1078,518,560,16,21,9,7,1,"High deviation in pkts_sent, NAT Destination Port, Destination Port"
55729,63805,38910,63805,allow,70,70,0,2,8,2,0,1,"High deviation in pkts_sent, NAT Destination Port, Destination Port"
26900,27017,38585,27017,allow,6466,3520,2946,38,46,21,17,1,"High deviation in pkts_sent, NAT Destination Port, Bytes Sent"
34750,80,47643,80,allow,111678,5254,106424,150,240,71,79,1,"High deviation in pkts_sent, Bytes Received, Bytes"
43199,5228,42030,5228,allow,10588,2455,8133,46,5724,19,27,1,"High deviation in pkts_sent, Elapsed Time (sec), Bytes"
59342,80,59342,80,allow,107768,4073,103695,177,15,58,119,1,"High deviation in pkts_sent, Bytes Received, Bytes"
58957,80,23483,80,allow,13330975,109486,13221489,10177,23,1394,8783,1,"High deviation in pkts_sent, Bytes Received, Bytes"
54898,443,54771,443,allow,78537,4022,74515,120,386,55,65,1,"High deviation in pkts_sent, Bytes Received, Bytes"
37965,56605,48626,56605,allow,847,152,695,4,1201,2,2,1,"High deviation in pkts_sent, NAT Destination Port, Destination Port"
64082,43786,41878,43786,allow,504,382,122,8,14,6,2,1,"High deviation in pkts_sent, NAT Destination Port, Destination Port"
64122,443,27502,443,allow,5121090,119252,5001838,5000,55,1680,3320,1,"High deviation in pkts_sent, Bytes Received, Bytes"
38135,80,24108,80,allow,111328,4904,106424,145,240,66,79,1,"High deviation in pkts_sent, Bytes Received, Bytes"
58991,443,64156,443,allow,972647,20727,951920,916,263,245,671,1,"High deviation in pkts_sent, Bytes Received, Bytes"
54030,443,52354,443,allow,249900,26024,223876,450,167,183,267,1,"High deviation in pkts_sent, Bytes Received, Bytes"
52218,62004,11964,62004,allow,136,136,0,3,12,3,0,1,"High deviation in pkts_sent, NAT Destination Port, Destination Port"
60502,61473,62296,61473,allow,1628,1037,591,14,16,8,6,1,"High deviation in pkts_sent, NAT Destination Port, Destination Port"
44246,5228,57956,5228,allow,19678,4762,14916,98,9851,54,44,1,"High deviation in pkts_sent, Elapsed Time (sec), Bytes Sent"
49231,443,44532,443,allow,474745,13542,461203,502,17,189,313,1,"High deviation in pkts_sent, Bytes Received, Bytes"
65522,443,46739,443,allow,399281,11940,387341,412,16,145,267,1,"High deviation in pkts_sent, Bytes Received, Bytes"
49126,443,33194,443,allow,3800867,77753,3723114,3263,625,478,2785,1,"High deviation in pkts_sent, Bytes Received, Bytes"
49591,5228,57295,5228,allow,18548,2772,15776,41,3957,17,24,1,"High deviation in pkts_sent, Elapsed Time (sec), Bytes Received"
61445,443,34767,443,allow,97211,3043,94168,109,121,37,72,1,"High deviation in pkts_sent, Bytes Received, Bytes"
49160,33586,34033,33586,allow,1377,300,1077,6,1200,3,3,1,"High deviation in pkts_sent, NAT Destination Port, Destination Port"
65066,80,65066,80,allow,874843,22526,852317,878,44,304,574,1,"High deviation in pkts_sent, Bytes Received, Bytes"
60503,53425,43534,53425,allow,504,318,186,8,16,5,3,1,"High deviation in pkts_sent, NAT Destination Port, Destination Port"
54892,443,40724,443,allow,602278,26008,576270,748,396,317,431,1,"High deviation in pkts_sent, Bytes Received, Bytes"
52213,56682,55020,56682,allow,66,66,0,1,5,1,0,1,"High deviation in NAT Destination Port, Destination Port, NAT Source Port"
49315,443,55462,443,allow,160961,7302,153659,171,87,49,122,1,"High deviation in pkts_sent, Bytes Received, Bytes"
43056,443,9640,443,allow,31297,21354,9943,55,363,28,27,1,"High deviation in pkts_sent, Bytes Sent, Bytes"
6881,16869,32052,16869,allow,509,150,359,2,1200,1,1,1,"High deviation in NAT Destination Port, Elapsed Time (sec), Destination Port"
53972,59089,19075,59089,allow,70,70,0,1,4,1,0,1,"High deviation in NAT Destination Port, Destination Port, NAT Source Port"
65523,443,11792,443,allow,92518,4869,87649,109,15,44,65,1,"High deviation in pkts_sent, Bytes Received, Bytes"
64083,63666,39336,63666,allow,70,70,0,1,4,1,0,1,"High deviation in NAT Destination Port, Destination Port, NAT Source Port"
52111,53162,33838,53162,allow,1330,706,624,10,33,6,4,1,"High deviation in pkts_sent, NAT Destination Port, Destination Port"
52124,443,40698,443,allow,78269,5330,72939,127,313,57,70,1,"High deviation in pkts_sent, Bytes Received, Bytes"
58877,443,35023,443,allow,183394,7389,176005,219,108,87,132,1,"High deviation in pkts_sent, Bytes Received, Bytes"
55845,443,55416,443,allow,505207,16025,489182,464,139,97,367,1,"High deviation in pkts_sent, Bytes Received, Bytes"
38001,49152,63633,49152,allow,156,156,0,3,8,3,0,1,"High deviation in pkts_sent, NAT Destination Port, Destination Port"
56746,80,35139,80,allow,876072,26350,849722,935,27,335,600,1,"High deviation in pkts_sent, Bytes Received, Bytes"
6881,51413,34368,51413,allow,207,118,89,2,1199,1,1,1,"High deviation in NAT Destination Port, Destination Port, Elapsed Time (sec)"
57470,31566,19027,31566,allow,481,150,331,2,1199,1,1,1,"High deviation in NAT Destination Port, Destination Port, Elapsed Time (sec)"
57470,15564,5143,15564,allow,1577,594,983,20,1624,10,10,1,"High deviation in pkts_sent, NAT Destination Port, Elapsed Time (sec)"
45316,80,11125,80,allow,3044854,64416,2980438,2968,19,997,1971,1,"High deviation in pkts_sent, Bytes Received, Bytes"
55877,54210,39473,54210,allow,490,149,341,2,1200,1,1,1,"High deviation in NAT Destination Port, Destination Port, Elapsed Time (sec)"
36515,80,38433,80,allow,51571,48786,2785,74,19,38,36,1,"High deviation in pkts_sent, Bytes Sent, Bytes"
52948,48482,33406,48482,allow,5180,2470,2710,49,339,25,24,1,"High deviation in pkts_sent, NAT Destination Port, Destination Port"
60507,53830,57450,53830,allow,320,140,180,6,6,3,3,1,"High deviation in pkts_sent, NAT Destination Port, Destination Port"
52244,58774,22208,58774,allow,70,70,0,2,6,2,0,1,"High deviation in pkts_sent, NAT Destination Port, Destination Port"
38715,443,52129,443,allow,403299,12717,390582,439,16,171,268,1,"High deviation in pkts_sent, Bytes Received, Bytes"
30188,56962,59522,56962,allow,2746,1487,1259,21,2495,14,7,1,"High deviation in pkts_sent, NAT Destination Port, Elapsed Time (sec)"
55053,80,18063,80,allow,162010,4343,157667,170,98,61,109,1,"High deviation in pkts_sent, Bytes Received, Bytes"
57575,443,3355,443,allow,707158,36853,670305,902,148,310,592,1,"High deviation in pkts_sent, Bytes Received, Bytes"
57470,36670,48397,36670,allow,3570,1126,2444,28,1465,16,12,1,"High deviation in pkts_sent, NAT Destination Port, Elapsed Time (sec)"
57571,443,57571,443,allow,881747,19604,862143,728,175,144,584,1,"High deviation in pkts_sent, Bytes Received, Bytes"
57572,443,57572,443,allow,181333,21870,159463,187,175,65,122,1,"High deviation in pkts_sent, Bytes Received, Bytes"
53984,57077,13402,57077,allow,70,70,0,2,8,2,0,1,"High deviation in pkts_sent, NAT Destination Port, Destination Port"
39683,443,12229,443,allow,101895,6430,95465,152,175,66,86,1,"High deviation in pkts_sent, Bytes Received, Bytes"
6882,30499,61301,30499,allow,150,150,0,1,1200,1,0,1,"High deviation in NAT Destination Port, Elapsed Time (sec), Destination Port"
53124,443,9153,443,allow,64407,55712,8695,92,364,58,34,1,"High deviation in pkts_sent, Bytes Sent, Bytes"
58873,443,27496,443,allow,1855088,42017,1813071,1821,49,531,1290,1,"High deviation in pkts_sent, Bytes Received, Bytes"
53960,61038,13704,61038,allow,552,306,246,9,14,5,4,1,"High deviation in pkts_sent, NAT Destination Port, Destination Port"
52202,64241,19062,64241,allow,250,66,184,4,9,2,2,1,"High deviation in pkts_sent, NAT Destination Port, Destination Port"
57574,443,57574,443,allow,164451,18310,146141,163,175,52,111,1,"High deviation in pkts_sent, Bytes Received, Bytes"
64093,64828,28561,64828,allow,66,66,0,2,7,2,0,1,"High deviation in pkts_sent, NAT Destination Port, Destination Port"
52398,443,30861,443,allow,323437,18923,304514,544,252,276,268,1,"High deviation in pkts_sent, Bytes Received, Bytes"
15503,63093,6070,63093,allow,481,150,331,2,1200,1,1,1,"High deviation in NAT Destination Port, Destination Port, Elapsed Time (sec)"
34107,443,34100,443,allow,11976,5066,6910,83,2475,43,40,1,"High deviation in pkts_sent, Bytes Sent, Elapsed Time (sec)"
60990,443,42071,443,allow,212824,12881,199943,244,49,101,143,1,"High deviation in pkts_sent, Bytes Received, Bytes"
57470,40794,36042,40794,allow,132,132,0,3,1199,3,0,1,"High deviation in pkts_sent, NAT Destination Port, Destination Port"
44847,37005,6154,37005,allow,150,150,0,1,1200,1,0,1,"High deviation in NAT Destination Port, Destination Port, Elapsed Time (sec)"
59339,80,59339,80,allow,107838,4143,103695,178,15,59,119,1,"High deviation in pkts_sent, Bytes Received, Bytes"
10151,27949,13472,27949,allow,469,149,320,2,1200,1,1,1,"High deviation in NAT Destination Port, Elapsed Time (sec), Destination Port"
51596,443,63040,443,allow,4638384,61757,4576627,3641,280,309,3332,1,"High deviation in pkts_sent, Bytes Received, Bytes"
47831,443,18559,443,allow,180582,6020,174562,196,200,70,126,1,"High deviation in pkts_sent, Bytes Received, Bytes"
47832,443,4961,443,allow,130090,7064,123026,184,200,92,92,1,"High deviation in pkts_sent, Bytes Received, Bytes"
49764,443,46462,443,allow,114197,7285,106912,177,77,85,92,1,"High deviation in pkts_sent, Bytes Received, Bytes"
48994,443,64205,443,allow,46452,6817,39635,103,299,45,58,1,"High deviation in pkts_sent, Bytes Received, Bytes"
53949,42301,56593,42301,allow,1396,719,677,15,15,8,7,1,"High deviation in pkts_sent, NAT Destination Port, Destination Port"
60496,56871,22838,56871,allow,504,318,186,8,15,5,3,1,"High deviation in pkts_sent, NAT Destination Port, Destination Port"
52220,65128,43562,65128,allow,70,70,0,2,8,2,0,1,"High deviation in pkts_sent, NAT Destination Port, Destination Port"
37965,48167,49022,48167,allow,490,149,341,3,1199,2,1,1,"High deviation in pkts_sent, NAT Destination Port, Destination Port"
50992,443,14898,443,allow,49212,42366,6846,109,147,59,50,1,"High deviation in pkts_sent, Bytes Sent, Bytes"
54526,443,1853,443,allow,33625519,489773,33135746,29877,243,6803,23074,1,"High deviation in pkts_sent, Bytes Received, Bytes"
52334,443,32129,443,allow,96091,8340,87751,159,205,75,84,1,"High deviation in pkts_sent, Bytes Received, Bytes"
30188,33365,39784,33365,allow,42329,18517,23812,241,2378,116,125,1,"High deviation in pkts_sent, Bytes Sent, NAT Destination Port"
51221,51413,53021,51413,allow,460,150,310,2,1200,1,1,1,"High deviation in NAT Destination Port, Destination Port, Elapsed Time (sec)"
53954,57868,29520,57868,allow,70,70,0,1,5,1,0,1,"High deviation in NAT Destination Port, Destination Port, NAT Source Port"
57470,53380,4441,53380,allow,330,330,0,6,1200,6,0,1,"High deviation in pkts_sent, NAT Destination Port, Destination Port"
64723,443,61032,443,allow,7978900,79979,7898921,6464,210,644,5820,1,"High deviation in pkts_sent, Bytes Received, Bytes"
19473,51413,49212,51413,allow,459,149,310,2,1200,1,1,1,"High deviation in NAT Destination Port, Destination Port, Elapsed Time (sec)"
61343,443,57856,443,allow,1784740,34746,1749994,1769,331,357,1412,1,"High deviation in pkts_sent, Bytes Received, Bytes"
52101,64162,42746,64162,allow,1200,576,624,8,31,4,4,1,"High deviation in pkts_sent, NAT Destination Port, Destination Port"
49228,443,55799,443,allow,842887,22143,820744,866,19,314,552,1,"High deviation in pkts_sent, Bytes Received, Bytes"
53101,443,16538,443,allow,27964,15805,12159,204,904,120,84,1,"High deviation in pkts_sent, Bytes Sent, Bytes"
51880,51880,39901,51880,allow,582,270,312,8,32,4,4,1,"High deviation in pkts_sent, NAT Destination Port, Destination Port"
10059,443,58839,443,allow,70553,6471,64082,141,182,69,72,1,"High deviation in pkts_sent, Bytes Received, Bytes"
42484,443,62904,443,allow,79507,72433,7074,96,415,60,36,1,"High deviation in pkts_sent, Bytes Sent, Bytes"
6881,56867,6114,56867,allow,150,150,0,1,1199,1,0,1,"High deviation in NAT Destination Port, Destination Port, Elapsed Time (sec)"
53497,443,53212,443,allow,17187157,553524,16633633,18453,352,6098,12355,1,"High deviation in pkts_sent, Bytes Received, Bytes"
61829,443,61829,443,allow,280243,73972,206271,309,206,142,167,1,"High deviation in pkts_sent, Bytes Sent, Bytes"
59335,80,59335,80,allow,107776,4213,103563,177,16,60,117,1,"High deviation in pkts_sent, Bytes Received, Bytes"
57956,443,29445,443,allow,7842,2164,5678,48,5441,20,28,1,"High deviation in pkts_sent, Elapsed Time (sec), Bytes Sent"
21133,11342,54289,11342,allow,478,149,329,2,1200,1,1,1,"High deviation in NAT Destination Port, Elapsed Time (sec), Destination Port"
53935,42874,31408,42874,allow,1973,1021,952,10,15,6,4,1,"High deviation in pkts_sent, NAT Destination Port, Destination Port"
38524,443,15396,443,allow,5846879,177697,5669182,6043,41,2261,3782,1,"High deviation in pkts_sent, Bytes Received, Bytes"
43357,443,61952,443,allow,146374,13143,133231,238,131,116,122,1,"High deviation in pkts_sent, Bytes Received, Bytes"
38143,443,25496,443,allow,84884,5896,78988,128,36,66,62,1,"High deviation in pkts_sent, Bytes Received, Bytes"
53931,55300,33330,55300,allow,492,306,186,8,15,5,3,1,"High deviation in pkts_sent, NAT Destination Port, Destination Port"
65521,443,8234,443,allow,92427,4519,87908,105,15,39,66,1,"High deviation in pkts_sent, Bytes Received, Bytes"
65520,443,22541,443,allow,438102,12780,425322,449,15,157,292,1,"High deviation in pkts_sent, Bytes Received, Bytes"
38474,28678,45201,28678,allow,1806,1806,0,22,224,22,0,1,"High deviation in pkts_sent, NAT Destination Port, Destination Port"
49443,443,17566,443,allow,70988,47020,23968,152,652,79,73,1,"High deviation in pkts_sent, Bytes Sent, Bytes"
58868,443,58939,443,allow,239435,36478,202957,319,111,133,186,1,"High deviation in pkts_sent, Bytes Received, Bytes"
39886,443,46428,443,allow,315567,15410,300157,404,46,189,215,1,"High deviation in pkts_sent, Bytes Received, Bytes"
46273,5228,19288,5228,allow,5239,1558,3681,27,4020,9,18,1,"High deviation in pkts_sent, Elapsed Time (sec), NAT Destination Port"
62547,443,41349,443,allow,54095,6413,47682,151,450,61,90,1,"High deviation in pkts_sent, Bytes Received, Bytes"
65519,443,19659,443,allow,436359,12780,423579,448,16,157,291,1,"High deviation in pkts_sent, Bytes Received, Bytes"
37965,61085,23932,61085,allow,132,132,0,3,1199,3,0,1,"High deviation in pkts_sent, NAT Destination Port, Destination Port"
64083,63666,21856,63666,allow,66,66,0,2,8,2,0,1,"High deviation in pkts_sent, NAT Destination Port, Destination Port"
38753,443,17390,443,allow,29887852,586245,29301607,27419,299,7975,19444,1,"High deviation in pkts_sent, Bytes Received, Bytes"
52213,56682,21348,56682,allow,70,70,0,2,6,2,0,1,"High deviation in pkts_sent, NAT Destination Port, Destination Port"
52169,59681,49857,59681,allow,66,66,0,1,5,1,0,1,"High deviation in NAT Destination Port, Destination Port, NAT Source Port"
49248,80,49248,80,allow,163556,12140,151416,207,22,97,110,1,"High deviation in pkts_sent, Bytes Received, Bytes"
49246,80,49246,80,allow,133699,9415,124284,169,23,77,92,1,"High deviation in pkts_sent, Bytes Received, Bytes"
55652,443,55652,443,allow,141647,19296,122351,203,55,102,101,1,"High deviation in pkts_sent, Bytes Received, Bytes"
49247,80,49247,80,allow,135755,6750,129005,160,22,68,92,1,"High deviation in pkts_sent, Bytes Received, Bytes"
49249,80,49249,80,allow,265842,14126,251716,311,22,136,175,1,"High deviation in pkts_sent, Bytes Received, Bytes"
57727,443,62460,443,allow,54944,4374,50570,88,361,44,44,1,"High deviation in pkts_sent, Bytes Received, Bytes"
50265,44822,26867,44822,allow,149,149,0,1,1200,1,0,1,"High deviation in NAT Destination Port, Destination Port, Elapsed Time (sec)"
52206,59077,23195,59077,allow,316,136,180,6,9,3,3,1,"High deviation in pkts_sent, NAT Destination Port, Destination Port"
53972,59089,65256,59089,allow,70,70,0,2,7,2,0,1,"High deviation in pkts_sent, NAT Destination Port, Destination Port"
52171,63033,25728,63033,allow,70,70,0,1,5,1,0,1,"High deviation in NAT Destination Port, Destination Port, NAT Source Port"
10019,443,53412,443,allow,1497912,26236,1471676,1321,121,299,1022,1,"High deviation in pkts_sent, Bytes Received, Bytes"
52168,62118,28732,62118,allow,70,70,0,1,5,1,0,1,"High deviation in NAT Destination Port, Destination Port, NAT Source Port"
50578,80,35081,80,allow,367162,17367,349795,470,143,214,256,1,"High deviation in pkts_sent, Bytes Received, Bytes"
52211,56648,57880,56648,allow,70,70,0,2,8,2,0,1,"High deviation in pkts_sent, NAT Destination Port, Destination Port"
65518,443,8967,443,allow,92157,4519,87638,105,15,39,66,1,"High deviation in pkts_sent, Bytes Received, Bytes"
54367,443,60704,443,allow,5892088,193411,5698677,6287,213,2098,4189,1,"High deviation in pkts_sent, Bytes Received, Bytes"
52182,60769,21483,60769,allow,70,70,0,1,5,1,0,1,"High deviation in NAT Destination Port, Destination Port, NAT Source Port"
38712,443,31171,443,allow,382972,9177,373795,378,16,120,258,1,"High deviation in pkts_sent, Bytes Received, Bytes"
62112,443,29747,443,allow,505589,13504,492085,462,345,91,371,1,"High deviation in pkts_sent, Bytes Received, Bytes"
52167,61948,3341,61948,allow,70,70,0,1,5,1,0,1,"High deviation in NAT Destination Port, Destination Port, Bytes Received"
49703,443,4967,443,allow,421435,16499,404936,388,210,95,293,1,"High deviation in pkts_sent, Bytes Received, Bytes"
49931,443,64224,443,allow,92352,5699,86653,105,134,35,70,1,"High deviation in pkts_sent, Bytes Received, Bytes"
57470,24409,44348,24409,allow,870,330,540,12,1501,6,6,1,"High deviation in pkts_sent, NAT Destination Port, Elapsed Time (sec)"
49709,443,24927,443,allow,523518,15431,508087,466,210,109,357,1,"High deviation in pkts_sent, Bytes Received, Bytes"
50015,443,26548,443,allow,59858,24345,35513,148,612,78,70,1,"High deviation in pkts_sent, Bytes Sent, Bytes"
49707,443,44929,443,allow,593578,18531,575047,531,210,128,403,1,"High deviation in pkts_sent, Bytes Received, Bytes"
57451,443,58507,443,allow,19175423,168230,19007193,15129,313,2298,12831,1,"High deviation in pkts_sent, Bytes Received, Bytes"
49704,443,41533,443,allow,513839,16341,497498,453,210,104,349,1,"High deviation in pkts_sent, Bytes Received, Bytes"
50017,443,54344,443,allow,51055,17321,33734,147,612,77,70,1,"High deviation in pkts_sent, Bytes Sent, Bytes"
6882,46440,39998,46440,allow,324,150,174,2,1200,1,1,1,"High deviation in NAT Destination Port, Destination Port, Elapsed Time (sec)"
30188,51403,44357,51403,allow,502,150,352,2,1200,1,1,1,"High deviation in NAT Destination Port, Destination Port, Elapsed Time (sec)"
35337,443,49436,443,allow,6550678,172191,6378487,6426,82,2117,4309,1,"High deviation in pkts_sent, Bytes Received, Bytes"
60498,55100,34970,55100,allow,258,70,188,4,8,2,2,1,"High deviation in pkts_sent, NAT Destination Port, Destination Port"
37965,51413,49792,51413,allow,789,152,637,4,1199,2,2,1,"High deviation in pkts_sent, NAT Destination Port, Destination Port"
6881,51184,15075,51184,allow,324,150,174,2,1203,1,1,1,"High deviation in NAT Destination Port, Destination Port, Elapsed Time (sec)"
57470,53250,48963,53250,allow,491,150,341,2,1199,1,1,1,"High deviation in NAT Destination Port, Destination Port, Elapsed Time (sec)"
50584,29040,20008,29040,allow,509,150,359,2,1200,1,1,1,"High deviation in NAT Destination Port, Elapsed Time (sec), Destination Port"
44847,58839,4824,58839,allow,501,150,351,2,1200,1,1,1,"High deviation in NAT Destination Port, Destination Port, Elapsed Time (sec)"
61740,443,6060,443,allow,92202,65396,26806,193,3454,68,125,1,"High deviation in pkts_sent, Bytes Sent, Bytes"
54865,443,54865,443,allow,125282,21435,103847,162,20,80,82,1,"High deviation in pkts_sent, Bytes Received, Bytes"
58836,443,33212,443,allow,383990,15580,368410,490,212,192,298,1,"High deviation in pkts_sent, Bytes Received, Bytes"
60490,62336,7987,62336,allow,504,318,186,8,15,5,3,1,"High deviation in pkts_sent, NAT Destination Port, Destination Port"
55609,443,14768,443,allow,13039,4388,8651,93,1191,47,46,1,"High deviation in pkts_sent, Bytes Sent, Bytes"
50265,41198,60886,41198,allow,330,330,0,6,1200,6,0,1,"High deviation in pkts_sent, NAT Destination Port, Destination Port"
55516,5228,12835,5228,allow,2769,1694,1075,20,3600,10,10,1,"High deviation in pkts_sent, Elapsed Time (sec), NAT Destination Port"
50265,63104,28604,63104,allow,330,330,0,6,1200,6,0,1,"High deviation in pkts_sent, NAT Destination Port, Destination Port"
53928,47287,32055,47287,allow,612,306,306,10,14,5,5,1,"High deviation in pkts_sent, NAT Destination Port, Destination Port"
48817,51414,48817,51414,allow,150,150,0,1,1200,1,0,1,"High deviation in NAT Destination Port, Destination Port, Elapsed Time (sec)"
51426,80,51426,80,allow,114697,3049,111648,114,26,35,79,1,"High deviation in pkts_sent, Bytes Received, Bytes"
53136,5228,42128,5228,allow,26821,4295,22526,95,5045,40,55,1,"High deviation in pkts_sent, Elapsed Time (sec), Bytes Received"
55877,55153,7894,55153,allow,481,150,331,2,1200,1,1,1,"High deviation in NAT Destination Port, Destination Port, Elapsed Time (sec)"
34572,443,63392,443,allow,52330,13948,38382,131,129,71,60,1,"High deviation in pkts_sent, Bytes Sent, Bytes"
50265,45589,64355,45589,allow,132,132,0,3,1200,3,0,1,"High deviation in pkts_sent, NAT Destination Port, Destination Port"
50265,54145,30228,54145,allow,858,858,0,14,1200,14,0,1,"High deviation in pkts_sent, NAT Destination Port, Destination Port"
52190,443,60064,443,allow,570322,21029,549293,569,46,181,388,1,"High deviation in pkts_sent, Bytes Received, Bytes"
59787,443,23637,443,allow,276238,23971,252267,482,138,188,294,1,"High deviation in pkts_sent, Bytes Received, Bytes"
57470,31373,26422,31373,allow,1386,1386,0,22,1798,22,0,1,"High deviation in pkts_sent, NAT Destination Port, Elapsed Time (sec)"
45706,443,50703,443,allow,512213,34626,477587,741,147,283,458,1,"High deviation in pkts_sent, Bytes Received, Bytes"
56906,443,9378,443,allow,1712418,88847,1623571,2014,149,715,1299,1,"High deviation in pkts_sent, Bytes Received, Bytes"
51142,443,51142,443,allow,261206,9686,251520,308,128,121,187,1,"High deviation in pkts_sent, Bytes Received, Bytes"
52001,80,20376,80,allow,8117874,148550,7969324,7318,25,2033,5285,1,"High deviation in pkts_sent, Bytes Received, Bytes"
49440,443,48823,443,allow,3721809,103604,3618205,3808,156,1281,2527,1,"High deviation in pkts_sent, Bytes Received, Bytes"
62349,443,37822,443,allow,3942042,47512,3894530,3167,53,526,2641,1,"High deviation in pkts_sent, Bytes Received, Bytes"
52100,443,42530,443,allow,14433889,278906,14154983,13633,66,4079,9554,1,"High deviation in pkts_sent, Bytes Received, Bytes"
50884,443,50884,443,allow,187790,7733,180057,229,128,90,139,1,"High deviation in pkts_sent, Bytes Received, Bytes"
36665,443,51014,443,allow,5814771,76275,5738496,4959,154,976,3983,1,"High deviation in pkts_sent, Bytes Received, Bytes"
52090,64823,30736,64823,allow,634,568,66,8,29,7,1,1,"High deviation in pkts_sent, NAT Destination Port, Destination Port"
56645,443,24912,443,allow,37030,24937,12093,83,1286,30,53,1,"High deviation in pkts_sent, Bytes Sent, Bytes"
49445,443,22095,443,allow,462587,17396,445191,527,130,198,329,1,"High deviation in pkts_sent, Bytes Received, Bytes"
6881,51719,22526,51719,allow,324,150,174,2,1199,1,1,1,"High deviation in NAT Destination Port, Destination Port, Elapsed Time (sec)"
15503,57141,65001,57141,allow,481,150,331,2,1200,1,1,1,"High deviation in NAT Destination Port, Destination Port, Elapsed Time (sec)"
33507,443,18740,443,allow,194174,11657,182517,258,31,124,134,1,"High deviation in pkts_sent, Bytes Received, Bytes"
52186,57609,20882,57609,allow,70,70,0,2,9,2,0,1,"High deviation in pkts_sent, NAT Destination Port, Destination Port"
61828,443,61828,443,allow,317388,25904,291484,338,200,128,210,1,"High deviation in pkts_sent, Bytes Received, Bytes"
53954,57868,45044,57868,allow,70,70,0,2,8,2,0,1,"High deviation in pkts_sent, NAT Destination Port, Destination Port"
56178,443,35008,443,allow,12283477,390003,11893474,13073,164,4327,8746,1,"High deviation in pkts_sent, Bytes Received, Bytes"
37965,58043,10741,58043,allow,6029,3652,2377,79,3221,45,34,1,"High deviation in pkts_sent, NAT Destination Port, Elapsed Time (sec)"
57665,5228,43757,5228,allow,2391,1434,957,16,3601,8,8,1,"High deviation in pkts_sent, Elapsed Time (sec), NAT Destination Port"
52749,443,45343,443,allow,148418,107579,40839,315,6090,107,208,1,"High deviation in pkts_sent, Bytes Sent, Bytes"
52155,63867,61917,63867,allow,70,70,0,1,5,1,0,1,"High deviation in NAT Destination Port, Destination Port, NAT Source Port"
65383,443,27965,443,allow,839325,38439,800886,1027,94,451,576,1,"High deviation in pkts_sent, Bytes Received, Bytes"
51221,44710,11229,44710,allow,481,150,331,2,1200,1,1,1,"High deviation in NAT Destination Port, Destination Port, Elapsed Time (sec)"
56431,443,60135,443,allow,55149,7806,47343,134,108,61,73,1,"High deviation in pkts_sent, Bytes Received, Bytes"
48038,5222,35034,5222,allow,49279,23110,26169,459,384,239,220,1,"High deviation in pkts_sent, Bytes Sent, Bytes"
44228,443,22389,443,allow,2754856,125760,2629096,3115,32,1340,1775,1,"High deviation in pkts_sent, Bytes Received, Bytes"
65516,443,35348,443,allow,451899,13130,438769,463,16,162,301,1,"High deviation in pkts_sent, Bytes Received, Bytes"
49570,443,47382,443,allow,162268,121343,40925,316,6101,108,208,1,"High deviation in pkts_sent, Bytes Sent, Bytes"
56629,443,11922,443,allow,23887293,546911,23340382,23137,108,7700,15437,1,"High deviation in pkts_sent, Bytes Received, Bytes"
62956,443,13888,443,allow,829275,26662,802613,884,129,295,589,1,"High deviation in pkts_sent, Bytes Received, Bytes"
59830,443,56581,443,allow,82533,15815,66718,124,131,50,74,1,"High deviation in pkts_sent, Bytes Received, Bytes"
44959,443,64557,443,allow,373033,19903,353130,469,143,180,289,1,"High deviation in pkts_sent, Bytes Received, Bytes"
10151,38030,53424,38030,allow,481,150,331,2,1200,1,1,1,"High deviation in NAT Destination Port, Destination Port, Elapsed Time (sec)"
49335,443,62056,443,allow,125790,4516,121274,118,55,28,90,1,"High deviation in pkts_sent, Bytes Received, Bytes"
38402,443,45229,443,allow,3830718,112946,3717772,4353,224,1395,2958,1,"High deviation in pkts_sent, Bytes Received, Bytes"
57339,443,64003,443,allow,1778020,204978,1573042,2589,987,1006,1583,1,"High deviation in pkts_sent, Bytes Received, Bytes"
52710,443,22445,443,allow,203346,21619,181727,301,376,140,161,1,"High deviation in pkts_sent, Bytes Received, Bytes"
59326,80,59326,80,allow,109128,4773,104355,197,16,68,129,1,"High deviation in pkts_sent, Bytes Received, Bytes"
51809,443,10522,443,allow,82930,18836,64094,131,128,55,76,1,"High deviation in pkts_sent, Bytes, Bytes Received"
19473,51413,8434,51413,allow,459,149,310,2,1200,1,1,1,"High deviation in NAT Destination Port, Destination Port, Elapsed Time (sec)"
41156,443,9223,443,allow,59486,3261,56225,74,360,29,45,1,"High deviation in pkts_sent, Bytes Received, Bytes"
38711,443,23557,443,allow,459089,10521,448568,449,16,141,308,1,"High deviation in pkts_sent, Bytes Received, Bytes"
57979,443,3610,443,allow,7970957,82522,7888435,6370,179,1027,5343,1,"High deviation in pkts_sent, Bytes Received, Bytes"
6881,26171,65454,26171,allow,219,118,101,2,1199,1,1,1,"High deviation in NAT Destination Port, Elapsed Time (sec), Destination Port"
60493,55172,57169,55172,allow,320,140,180,6,7,3,3,1,"High deviation in pkts_sent, NAT Destination Port, Destination Port"
55710,63545,52051,63545,allow,504,318,186,8,15,5,3,1,"High deviation in pkts_sent, NAT Destination Port, Destination Port"
43477,443,38784,443,allow,20739,7254,13485,97,734,44,53,1,"High deviation in pkts_sent, Bytes Sent, Bytes"
41786,443,30860,443,allow,174542,9281,165261,227,78,104,123,1,"High deviation in pkts_sent, Bytes Received, Bytes"
65517,443,57866,443,allow,92117,4799,87318,107,15,43,64,1,"High deviation in pkts_sent, Bytes Received, Bytes"
8941,443,25184,443,allow,541643,15245,526398,507,416,103,404,1,"High deviation in pkts_sent, Bytes Received, Bytes"
52152,58114,56068,58114,allow,70,70,0,1,5,1,0,1,"High deviation in NAT Destination Port, Destination Port, NAT Source Port"
50584,49001,53256,49001,allow,480,150,330,2,1200,1,1,1,"High deviation in NAT Destination Port, Destination Port, Elapsed Time (sec)"
57594,80,57594,80,allow,110070,5374,104696,112,156,36,76,1,"High deviation in pkts_sent, Bytes Received, Bytes"
52184,57262,18616,57262,allow,70,70,0,2,8,2,0,1,"High deviation in pkts_sent, NAT Destination Port, Destination Port"
30960,45761,37537,45761,allow,462,462,0,8,3632,8,0,1,"High deviation in pkts_sent, NAT Destination Port, Elapsed Time (sec)"
30960,45760,12069,45760,allow,462,462,0,8,3632,8,0,1,"High deviation in pkts_sent, NAT Destination Port, Elapsed Time (sec)"
41688,443,15969,443,allow,626036,38764,587272,713,191,245,468,1,"High deviation in pkts_sent, Bytes Received, Bytes"
21133,33447,47731,33447,allow,481,150,331,2,1199,1,1,1,"High deviation in NAT Destination Port, Destination Port, Elapsed Time (sec)"
44307,443,62796,443,allow,92044,19483,72561,147,186,55,92,1,"High deviation in pkts_sent, Bytes Received, Bytes"
38113,443,46610,443,allow,2849678,105912,2743766,3255,124,1284,1971,1,"High deviation in pkts_sent, Bytes Received, Bytes"
55966,443,29704,443,allow,214312,69934,144378,612,671,303,309,1,"High deviation in pkts_sent, Bytes Sent, Bytes"
52182,60769,63523,60769,allow,70,70,0,2,8,2,0,1,"High deviation in pkts_sent, NAT Destination Port, Destination Port"
52202,64241,11975,64241,allow,164,70,94,2,4,1,1,1,"High deviation in NAT Destination Port, Destination Port, Bytes Sent"
43218,443,34506,443,allow,2683108,71922,2611186,2467,150,623,1844,1,"High deviation in pkts_sent, Bytes Received, Bytes"
38066,443,48945,443,allow,328599,275779,52820,868,342,483,385,1,"High deviation in pkts_sent, Bytes Sent, Bytes"
59829,443,54560,443,allow,948180,35714,912466,1121,119,378,743,1,"High deviation in pkts_sent, Bytes Received, Bytes"
41906,80,41906,80,allow,127215,3221,123994,137,3685,42,95,1,"High deviation in pkts_sent, Bytes Received, Bytes"
43226,443,42884,443,allow,1583877,43930,1539947,1405,93,297,1108,1,"High deviation in pkts_sent, Bytes Received, Bytes"
30188,14038,49780,14038,allow,502,150,352,2,1200,1,1,1,"High deviation in NAT Destination Port, Elapsed Time (sec), Destination Port"
45418,443,36338,443,allow,137754,15176,122578,229,99,106,123,1,"High deviation in pkts_sent, Bytes Received, Bytes"
38065,443,63801,443,allow,911697,74083,837614,1247,343,459,788,1,"High deviation in pkts_sent, Bytes Received, Bytes"
57470,13613,11885,13613,allow,1577,594,983,20,1601,10,10,1,"High deviation in pkts_sent, NAT Destination Port, Elapsed Time (sec)"
48110,443,9219,443,allow,537031,23421,513610,622,43,258,364,1,"High deviation in pkts_sent, Bytes Received, Bytes"
52709,443,18513,443,allow,266282,13744,252538,313,374,128,185,1,"High deviation in pkts_sent, Bytes Received, Bytes"
61508,443,13468,443,allow,215490,8471,207019,194,45,45,149,1,"High deviation in pkts_sent, Bytes Received, Bytes"
61507,443,11095,443,allow,443128,10267,432861,362,45,60,302,1,"High deviation in pkts_sent, Bytes Received, Bytes"
39353,9339,55496,9339,allow,170706,9877,160829,260,46,110,150,1,"High deviation in pkts_sent, Bytes Received, Bytes"
35066,443,6201,443,allow,33823,28233,5590,84,102,47,37,1,"High deviation in pkts_sent, Bytes Sent, Bytes"
65426,80,28723,80,allow,65980,5156,60824,86,23,39,47,1,"High deviation in pkts_sent, Bytes Received, Bytes"
57470,64050,27080,64050,allow,1660,677,983,20,1600,10,10,1,"High deviation in pkts_sent, NAT Destination Port, Destination Port"
32914,5222,62781,5222,allow,8702,4668,4034,92,626,50,42,1,"High deviation in pkts_sent, Bytes Sent, NAT Destination Port"
9417,443,16764,443,allow,324745,7830,316915,327,31,112,215,1,"High deviation in pkts_sent, Bytes Received, Bytes"
50265,60276,27315,60276,allow,481,150,331,2,1200,1,1,1,"High deviation in NAT Destination Port, Destination Port, Elapsed Time (sec)"
33583,443,54351,443,allow,479444,14906,464538,489,62,173,316,1,"High deviation in pkts_sent, Bytes Received, Bytes"
52171,63033,49679,63033,allow,70,70,0,2,8,2,0,1,"High deviation in pkts_sent, NAT Destination Port, Destination Port"
34378,443,1903,443,allow,11269403,319214,10950189,11392,382,3773,7619,1,"High deviation in pkts_sent, Bytes Received, Bytes"
52169,59681,50827,59681,allow,70,70,0,2,8,2,0,1,"High deviation in pkts_sent, NAT Destination Port, Destination Port"
54340,443,58977,443,allow,79305,3202,76103,98,347,32,66,1,"High deviation in pkts_sent, Bytes Received, Bytes"
57470,51413,33371,51413,allow,460,150,310,2,1199,1,1,1,"High deviation in NAT Destination Port, Destination Port, Elapsed Time (sec)"
57040,443,58515,443,allow,59451,47894,11557,177,91,99,78,1,"High deviation in pkts_sent, Bytes Sent, Bytes"
49392,80,13895,80,allow,156587,46628,109959,307,314,203,104,1,"High deviation in pkts_sent, Bytes Sent, Bytes"
49226,443,24983,443,allow,532687,14365,518322,560,20,211,349,1,"High deviation in pkts_sent, Bytes Received, Bytes"
32911,443,37831,443,allow,970703,43045,927658,1244,141,563,681,1,"High deviation in pkts_sent, Bytes Received, Bytes"
53914,44209,7956,44209,allow,1729,985,744,16,16,9,7,1,"High deviation in pkts_sent, NAT Destination Port, Destination Port"
49905,443,37995,443,allow,798502,33164,765338,927,103,379,548,1,"High deviation in pkts_sent, Bytes Received, Bytes"
21447,53,34557,53,allow,80280,68084,12196,889,90,816,73,1,"High deviation in pkts_sent, Bytes Sent, Packets"
53934,48339,61953,48339,allow,320,140,180,6,6,3,3,1,"High deviation in pkts_sent, NAT Destination Port, Destination Port"
52168,62118,2887,62118,allow,70,70,0,2,8,2,0,1,"High deviation in pkts_sent, NAT Destination Port, Destination Port"
51635,80,51635,80,allow,699944,13137,686807,676,20,195,481,1,"High deviation in pkts_sent, Bytes Received, Bytes"
32909,443,28727,443,allow,160821,7879,152942,201,141,88,113,1,"High deviation in pkts_sent, Bytes Received, Bytes"
40355,443,8929,443,allow,15367456,244322,15123134,12866,268,1819,11047,1,"High deviation in pkts_sent, Bytes Received, Bytes"
32910,443,36297,443,allow,2299332,50663,2248669,2117,141,553,1564,1,"High deviation in pkts_sent, Bytes Received, Bytes"
32908,443,31863,443,allow,1780845,46018,1734827,1751,141,546,1205,1,"High deviation in pkts_sent, Bytes Received, Bytes"
60066,80,60066,80,allow,355862,9048,346814,358,163,116,242,1,"High deviation in pkts_sent, Bytes Received, Bytes"
48713,80,15220,80,allow,3588672,75353,3513319,3500,154,1175,2325,1,"High deviation in pkts_sent, Bytes Received, Bytes"
56716,80,53461,80,allow,3742344,115431,3626913,3995,79,1382,2613,1,"High deviation in pkts_sent, Bytes Received, Bytes"
49160,61365,56372,61365,allow,502,150,352,3,1200,2,1,1,"High deviation in pkts_sent, NAT Destination Port, Destination Port"
55859,443,4096,443,allow,399086,26649,372437,488,462,156,332,1,"High deviation in pkts_sent, Bytes Received, Bytes"
50265,27813,47510,27813,allow,198,198,0,4,1200,4,0,1,"High deviation in pkts_sent, NAT Destination Port, Elapsed Time (sec)"
59788,443,27023,443,allow,248845,14935,233910,308,49,148,160,1,"High deviation in pkts_sent, Bytes Received, Bytes"
39915,443,23556,443,allow,27886,17603,10283,138,462,76,62,1,"High deviation in pkts_sent, Bytes Sent, Bytes"
52167,61948,12539,61948,allow,70,70,0,2,8,2,0,1,"High deviation in pkts_sent, NAT Destination Port, Destination Port"
52166,57975,14625,57975,allow,70,70,0,2,8,2,0,1,"High deviation in pkts_sent, NAT Destination Port, Destination Port"
39714,443,60107,443,allow,922046,41258,880788,1106,218,498,608,1,"High deviation in pkts_sent, Bytes Received, Bytes"
39719,443,7093,443,allow,450036,17745,432291,541,217,241,300,1,"High deviation in pkts_sent, Bytes Received, Bytes"
46563,443,26794,443,allow,127147,41867,85280,198,240,91,107,1,"High deviation in pkts_sent, Bytes Sent, Bytes"
38135,443,62915,443,allow,2568507,98538,2469969,2956,65,1228,1728,1,"High deviation in pkts_sent, Bytes Received, Bytes"
59789,443,29818,443,allow,103556,8767,94789,144,48,75,69,1,"High deviation in pkts_sent, Bytes Received, Bytes"
59790,443,41784,443,allow,238429,14932,223497,314,48,159,155,1,"High deviation in pkts_sent, Bytes Received, Bytes"
49670,443,17269,443,allow,98424,28850,69574,508,2054,274,234,1,"High deviation in pkts_sent, Bytes Sent, Bytes"
50637,80,36749,80,allow,175050,8089,166961,167,48,48,119,1,"High deviation in pkts_sent, Bytes Received, Bytes"
59787,443,50421,443,allow,173218,14836,158382,227,48,114,113,1,"High deviation in pkts_sent, Bytes Received, Bytes"
59786,443,7763,443,allow,170002,17069,152933,229,48,118,111,1,"High deviation in pkts_sent, Bytes Received, Bytes"
21447,53,55331,53,allow,245648,213726,31922,2763,89,2579,184,1,"High deviation in pkts_sent, Bytes Sent, Packets"
6881,47488,39178,47488,allow,150,150,0,2,1200,2,0,1,"High deviation in pkts_sent, NAT Destination Port, Destination Port"
51996,80,49659,80,allow,6518746,206365,6312381,6886,22,2687,4199,1,"High deviation in pkts_sent, Bytes Received, Bytes"
59785,443,14021,443,allow,1077274,41232,1036042,1152,49,455,697,1,"High deviation in pkts_sent, Bytes Received, Bytes"
42813,443,40546,443,allow,1241645,28525,1213120,1200,65,328,872,1,"High deviation in pkts_sent, Bytes Received, Bytes"
41940,443,2811,443,allow,26974,22004,4970,80,216,42,38,1,"High deviation in pkts_sent, Bytes Sent, Bytes"
53925,61701,5754,61701,allow,70,70,0,2,8,2,0,1,"High deviation in pkts_sent, NAT Destination Port, Destination Port"
50356,443,55689,443,allow,505625,19174,486451,584,143,204,380,1,"High deviation in pkts_sent, Bytes Received, Bytes"
57021,443,20461,443,allow,227559,47160,180399,379,143,187,192,1,"High deviation in pkts_sent, Bytes Received, Bytes"
65515,443,2957,443,allow,419763,12080,407683,429,16,147,282,1,"High deviation in pkts_sent, Bytes Received, Bytes"
6881,48947,47849,48947,allow,228,118,110,2,1199,1,1,1,"High deviation in NAT Destination Port, Destination Port, Elapsed Time (sec)"
4544,41599,1547,41599,allow,710,710,0,6,302,6,0,1,"High deviation in pkts_sent, NAT Destination Port, Destination Port"
52004,80,9207,80,allow,84657,4275,80382,105,19,45,60,1,"High deviation in pkts_sent, Bytes Received, Bytes"
46212,443,38830,443,allow,67265,57889,9376,174,102,98,76,1,"High deviation in pkts_sent, Bytes Sent, Bytes"
26900,27017,55723,27017,allow,20322,11404,8918,118,133,67,51,1,"High deviation in pkts_sent, NAT Destination Port, Bytes Sent"
56263,443,47325,443,allow,101747,13436,88311,135,319,53,82,1,"High deviation in pkts_sent, Bytes Received, Bytes"
59810,443,33915,443,allow,630054,19786,610268,711,381,261,450,1,"High deviation in pkts_sent, Bytes Received, Bytes"
37682,5228,19029,5228,allow,5554,755,4799,14,3600,8,6,1,"High deviation in pkts_sent, Elapsed Time (sec), NAT Destination Port"
15503,61471,17657,61471,allow,490,149,341,2,1200,1,1,1,"High deviation in NAT Destination Port, Destination Port, Elapsed Time (sec)"
37965,18122,9264,18122,allow,3957,2324,1633,51,1794,29,22,1,"High deviation in pkts_sent, NAT Destination Port, Elapsed Time (sec)"
59377,443,61380,443,allow,43483,26315,17168,86,62,54,32,1,"High deviation in pkts_sent, Bytes Sent, Bytes"
38709,443,40146,443,allow,398925,9369,389556,391,16,123,268,1,"High deviation in pkts_sent, Bytes Received, Bytes"
55705,54638,46726,54638,allow,504,318,186,8,15,5,3,1,"High deviation in pkts_sent, NAT Destination Port, Destination Port"
63873,61002,7411,61002,allow,5431,3164,2267,32,76,18,14,1,"High deviation in pkts_sent, NAT Destination Port, Destination Port"
63141,55860,18547,55860,allow,316,190,126,5,15,3,2,1,"High deviation in pkts_sent, NAT Destination Port, Destination Port"
65514,443,30386,443,allow,92638,4519,88119,105,15,39,66,1,"High deviation in pkts_sent, Bytes Received, Bytes"
53929,60741,10876,60741,allow,320,140,180,6,6,3,3,1,"High deviation in pkts_sent, NAT Destination Port, Destination Port"
58863,443,30901,443,allow,4546411,95150,4451261,4312,109,1197,3115,1,"High deviation in pkts_sent, Bytes Received, Bytes"
50265,53606,10997,53606,allow,528,528,0,9,1200,9,0,1,"High deviation in pkts_sent, NAT Destination Port, Destination Port"
55435,443,60769,443,allow,684908,25994,658914,762,141,263,499,1,"High deviation in pkts_sent, Bytes Received, Bytes"
44099,443,23895,443,allow,8049289,98432,7950857,6501,125,717,5784,1,"High deviation in pkts_sent, Bytes Received, Bytes"
55160,443,10978,443,allow,333522,14341,319181,347,129,109,238,1,"High deviation in pkts_sent, Bytes Received, Bytes"
30960,45751,20805,45751,allow,66,66,0,1,3600,1,0,1,"High deviation in NAT Destination Port, Elapsed Time (sec), Destination Port"
59148,443,64998,443,allow,26615,22329,4286,52,272,30,22,1,"High deviation in pkts_sent, Bytes Sent, Bytes"
30960,45758,64660,45758,allow,462,462,0,8,3632,8,0,1,"High deviation in pkts_sent, NAT Destination Port, Elapsed Time (sec)"
6882,5406,43769,5406,allow,654,150,504,3,1200,1,2,1,"High deviation in NAT Destination Port, Elapsed Time (sec), Destination Port"
56249,443,29498,443,allow,80340,72269,8071,106,122,65,41,1,"High deviation in pkts_sent, Bytes Sent, Bytes"
50584,34393,36839,34393,allow,509,150,359,2,1200,1,1,1,"High deviation in NAT Destination Port, Destination Port, Elapsed Time (sec)"
61528,443,29665,443,allow,138544,7073,131471,165,144,59,106,1,"High deviation in pkts_sent, Bytes Received, Bytes"
39617,80,39617,80,allow,419378,16035,403343,506,132,226,280,1,"High deviation in pkts_sent, Bytes Received, Bytes"
52155,63867,51864,63867,allow,70,70,0,2,7,2,0,1,"High deviation in pkts_sent, NAT Destination Port, Destination Port"
57235,15187,23276,15187,allow,1269359015,948477220,320881795,1036116,9283,747520,288596,1,"High deviation in pkts_sent, Bytes Sent, Bytes"
41484,443,26840,443,allow,433834,12764,421070,452,32,156,296,1,"High deviation in pkts_sent, Bytes Received, Bytes"
50472,443,48641,443,allow,251744,9600,242144,302,23,129,173,1,"High deviation in pkts_sent, Bytes Received, Bytes"
62061,443,61994,443,allow,53531,5139,48392,75,47,34,41,1,"High deviation in pkts_sent, Bytes Received, Bytes"
50577,80,14735,80,allow,469212,19981,449231,601,134,276,325,1,"High deviation in pkts_sent, Bytes Received, Bytes"
41139,443,57233,443,allow,9152383,160511,8991872,8428,252,2261,6167,1,"High deviation in pkts_sent, Bytes Received, Bytes"
27777,80,27777,80,allow,12281469,369857,11911612,13837,31,5536,8301,1,"High deviation in pkts_sent, Bytes Received, Bytes"
51221,45722,40795,45722,allow,481,150,331,2,1200,1,1,1,"High deviation in NAT Destination Port, Destination Port, Elapsed Time (sec)"
36588,5223,46105,5223,allow,4336,1518,2818,23,3005,14,9,1,"High deviation in pkts_sent, Elapsed Time (sec), NAT Destination Port"
44847,20009,63949,20009,allow,502,150,352,2,1200,1,1,1,"High deviation in NAT Destination Port, Elapsed Time (sec), Destination Port"
37965,52608,29898,52608,allow,1577,594,983,20,2766,10,10,1,"High deviation in pkts_sent, NAT Destination Port, Elapsed Time (sec)"
52152,58114,40189,58114,allow,70,70,0,2,8,2,0,1,"High deviation in pkts_sent, NAT Destination Port, Destination Port"
60484,52001,52870,52001,allow,320,140,180,6,8,3,3,1,"High deviation in pkts_sent, NAT Destination Port, Destination Port"
49068,443,37354,443,allow,98965,16634,82331,187,30,82,105,1,"High deviation in pkts_sent, Bytes Received, Bytes"
52160,49212,45447,49212,allow,316,136,180,6,6,3,3,1,"High deviation in pkts_sent, NAT Destination Port, Destination Port"
53905,50130,9021,50130,allow,552,306,246,9,16,5,4,1,"High deviation in pkts_sent, NAT Destination Port, Destination Port"
37567,443,40594,443,allow,149229,139639,9590,226,256,124,102,1,"High deviation in pkts_sent, Bytes Sent, Bytes"
56524,443,60258,443,allow,759397,22470,736927,766,108,270,496,1,"High deviation in pkts_sent, Bytes Received, Bytes"
30960,45750,9630,45750,allow,66,66,0,1,3600,1,0,1,"High deviation in NAT Destination Port, Elapsed Time (sec), Destination Port"
58748,443,1980,443,allow,522925,36953,485972,799,229,304,495,1,"High deviation in pkts_sent, Bytes Received, Bytes"
53901,44425,38536,44425,allow,1686,890,796,10,15,6,4,1,"High deviation in pkts_sent, NAT Destination Port, Destination Port"
41482,443,54813,443,allow,1062197,37438,1024759,1129,31,416,713,1,"High deviation in pkts_sent, Bytes Received, Bytes"
51852,443,17719,443,allow,1382291,55962,1326329,1491,24,582,909,1,"High deviation in pkts_sent, Bytes Received, Bytes"
57470,29633,40389,29633,allow,1660,677,983,20,1595,10,10,1,"High deviation in pkts_sent, NAT Destination Port, Elapsed Time (sec)"
53900,45682,23799,45682,allow,492,306,186,8,15,5,3,1,"High deviation in pkts_sent, NAT Destination Port, Destination Port"
50320,80,20341,80,allow,50565,32661,17904,77,167,39,38,1,"High deviation in pkts_sent, Bytes Sent, Bytes"
56540,443,45404,443,allow,103117,6206,96911,127,106,54,73,1,"High deviation in pkts_sent, Bytes Received, Bytes"
36883,80,30047,80,allow,114410,3755,110655,128,38,47,81,1,"High deviation in pkts_sent, Bytes Received, Bytes"
26989,80,26989,80,allow,256062,8754,247308,297,18,124,173,1,"High deviation in pkts_sent, Bytes Received, Bytes"
6881,51413,17965,51413,allow,150,150,0,1,1200,1,0,1,"High deviation in NAT Destination Port, Destination Port, Elapsed Time (sec)"
53282,443,7574,443,allow,604924,37384,567540,846,154,315,531,1,"High deviation in pkts_sent, Bytes Received, Bytes"
60483,57723,53854,57723,allow,320,140,180,6,6,3,3,1,"High deviation in pkts_sent, NAT Destination Port, Destination Port"
58832,443,61522,443,allow,274798,9459,265339,343,201,136,207,1,"High deviation in pkts_sent, Bytes Received, Bytes"
45694,80,47472,80,allow,154671,9533,145138,227,38,121,106,1,"High deviation in pkts_sent, Bytes Received, Bytes"
52114,64853,36038,64853,allow,70,70,0,1,5,1,0,1,"High deviation in NAT Destination Port, Destination Port, NAT Source Port"
49358,443,12762,443,allow,137147,82203,54944,174,105,103,71,1,"High deviation in pkts_sent, Bytes Sent, Bytes"
38619,443,65221,443,allow,469799,14616,455183,474,129,155,319,1,"High deviation in pkts_sent, Bytes Received, Bytes"
41474,443,57047,443,allow,2767442,82304,2685138,2961,85,1088,1873,1,"High deviation in pkts_sent, Bytes Received, Bytes"
52003,80,9765,80,allow,88807,5957,82850,113,15,54,59,1,"High deviation in pkts_sent, Bytes Received, Bytes"
41473,443,44182,443,allow,4987881,144889,4842992,5257,85,1888,3369,1,"High deviation in pkts_sent, Bytes Received, Bytes"
53897,46913,50139,46913,allow,552,306,246,9,15,5,4,1,"High deviation in pkts_sent, NAT Destination Port, Destination Port"
52116,64692,3805,64692,allow,70,70,0,1,5,1,0,1,"High deviation in NAT Destination Port, Destination Port, Bytes Received"
54143,7000,54143,7000,allow,770727,19843,750884,802,16,295,507,1,"High deviation in pkts_sent, Bytes Received, Bytes"
21133,51413,27138,51413,allow,460,150,310,2,1199,1,1,1,"High deviation in NAT Destination Port, Destination Port, Elapsed Time (sec)"
41475,443,20491,443,allow,1251209,30056,1221153,1238,85,386,852,1,"High deviation in pkts_sent, Bytes Received, Bytes"
56480,80,24972,80,allow,289731,8487,281244,294,136,104,190,1,"High deviation in pkts_sent, Bytes Received, Bytes"
56482,80,53743,80,allow,180583,6825,173758,188,136,68,120,1,"High deviation in pkts_sent, Bytes Received, Bytes"
55390,443,55390,443,allow,164571,13257,151314,206,19,95,111,1,"High deviation in pkts_sent, Bytes Received, Bytes"
65073,80,65073,80,allow,169702,10513,159189,187,23,72,115,1,"High deviation in pkts_sent, Bytes Received, Bytes"
49951,80,49951,80,allow,24361943,451235,23910708,22804,63,6533,16271,1,"High deviation in pkts_sent, Bytes Received, Bytes"
52109,60841,45067,60841,allow,156,66,90,2,5,1,1,1,"High deviation in NAT Destination Port, Destination Port, NAT Source Port"
51683,5228,43500,5228,allow,9476,2759,6717,27,3601,15,12,1,"High deviation in pkts_sent, Elapsed Time (sec), Bytes Sent"
57470,39541,8082,39541,allow,792,792,0,13,1200,13,0,1,"High deviation in pkts_sent, NAT Destination Port, Destination Port"
40651,443,45721,443,allow,41517,28432,13085,89,601,47,42,1,"High deviation in pkts_sent, Bytes Sent, Bytes"
41472,443,61400,443,allow,680618,28384,652234,828,84,356,472,1,"High deviation in pkts_sent, Bytes Received, Bytes"
56535,443,1772,443,allow,185925,12445,173480,210,105,82,128,1,"High deviation in pkts_sent, Bytes Received, Bytes"
41471,443,22977,443,allow,1973617,48070,1925547,1945,84,606,1339,1,"High deviation in pkts_sent, Bytes Received, Bytes"
49750,5223,50752,5223,allow,46785,27735,19050,232,5491,123,109,1,"High deviation in pkts_sent, Bytes Sent, Bytes"
56532,443,14584,443,allow,198167,11702,186465,220,105,84,136,1,"High deviation in pkts_sent, Bytes Received, Bytes"
65070,80,65070,80,allow,145038,9857,135181,162,23,62,100,1,"High deviation in pkts_sent, Bytes Received, Bytes"
65071,80,65071,80,allow,296372,11959,284413,311,23,113,198,1,"High deviation in pkts_sent, Bytes Received, Bytes"
65067,80,65067,80,allow,342198,13793,328405,355,23,126,229,1,"High deviation in pkts_sent, Bytes Received, Bytes"
35338,443,31577,443,allow,571121,38361,532760,718,69,342,376,1,"High deviation in pkts_sent, Bytes Received, Bytes"
56531,443,49300,443,allow,215863,14423,201440,245,105,95,150,1,"High deviation in pkts_sent, Bytes Received, Bytes"
56534,443,29507,443,allow,265430,17951,247479,305,105,122,183,1,"High deviation in pkts_sent, Bytes Received, Bytes"
49330,443,57448,443,allow,137414,6004,131410,170,80,59,111,1,"High deviation in pkts_sent, Bytes Received, Bytes"
56489,80,59923,80,allow,118508,4979,113529,128,135,48,80,1,"High deviation in pkts_sent, Bytes Received, Bytes"
54636,443,3394,443,allow,311000,8576,302424,319,175,103,216,1,"High deviation in pkts_sent, Bytes Received, Bytes"
45397,443,38399,443,allow,970804,44459,926345,1113,200,446,667,1,"High deviation in pkts_sent, Bytes Received, Bytes"
65072,80,65072,80,allow,250600,11390,239210,268,23,98,170,1,"High deviation in pkts_sent, Bytes Received, Bytes"
56536,443,5996,443,allow,210110,14803,195307,246,105,103,143,1,"High deviation in pkts_sent, Bytes Received, Bytes"
56533,443,15782,443,allow,306579,19447,287132,335,105,129,206,1,"High deviation in pkts_sent, Bytes Received, Bytes"
50265,58840,23141,58840,allow,132,132,0,3,1200,3,0,1,"High deviation in pkts_sent, NAT Destination Port, Destination Port"
6881,35179,42052,35179,allow,228,118,110,2,1199,1,1,1,"High deviation in NAT Destination Port, Destination Port, Elapsed Time (sec)"
50265,25490,26928,25490,allow,1766,1332,434,22,1200,15,7,1,"High deviation in pkts_sent, NAT Destination Port, Elapsed Time (sec)"
6881,50239,58874,50239,allow,3514,1874,1640,15,1200,8,7,1,"High deviation in pkts_sent, NAT Destination Port, Destination Port"
57281,443,25432,443,allow,212477,8324,204153,232,122,79,153,1,"High deviation in pkts_sent, Bytes Received, Bytes"
50265,49754,28018,49754,allow,402,132,270,6,1209,3,3,1,"High deviation in pkts_sent, NAT Destination Port, Destination Port"
50615,80,48256,80,allow,190675,79205,111470,237,41,104,133,1,"High deviation in pkts_sent, Bytes Sent, Bytes"
59644,443,54066,443,allow,8362065,55143,8306922,6375,152,332,6043,1,"High deviation in pkts_sent, Bytes Received, Bytes"
50293,80,34278,80,allow,134242,13446,120796,154,161,58,96,1,"High deviation in pkts_sent, Bytes Received, Bytes"
60006,443,38577,443,allow,185169,75281,109888,426,111,209,217,1,"High deviation in pkts_sent, Bytes Sent, Bytes"
50298,80,48126,80,allow,166956,16834,150122,187,161,72,115,1,"High deviation in pkts_sent, Bytes Received, Bytes"
56479,80,1802,80,allow,460182,11717,448465,462,135,162,300,1,"High deviation in pkts_sent, Bytes Received, Bytes"
50297,80,4817,80,allow,145266,14613,130653,165,161,63,102,1,"High deviation in pkts_sent, Bytes Received, Bytes"
53886,49618,46889,49618,allow,492,306,186,8,16,5,3,1,"High deviation in pkts_sent, NAT Destination Port, Destination Port"
37694,5228,64819,5228,allow,6930,1665,5265,18,3601,9,9,1,"High deviation in pkts_sent, Elapsed Time (sec), NAT Destination Port"
38102,5228,57941,5228,allow,4235,1797,2438,38,4443,13,25,1,"High deviation in pkts_sent, Elapsed Time (sec), NAT Destination Port"
54054,5228,24551,5228,allow,8767,2486,6281,45,6062,24,21,1,"High deviation in pkts_sent, Elapsed Time (sec), Bytes Sent"
6881,6881,62439,6881,allow,502,150,352,2,1200,1,1,1,"High deviation in NAT Destination Port, Elapsed Time (sec), Destination Port"
53885,50379,49864,50379,allow,492,306,186,8,15,5,3,1,"High deviation in pkts_sent, NAT Destination Port, Destination Port"
56638,443,50177,443,allow,44984,28294,16690,77,40,40,37,1,"High deviation in pkts_sent, Bytes Sent, Bytes"
60021,443,37470,443,allow,346221,14712,331509,474,107,211,263,1,"High deviation in pkts_sent, Bytes Received, Bytes"
54634,443,32455,443,allow,225732,7330,218402,246,174,86,160,1,"High deviation in pkts_sent, Bytes Received, Bytes"
38707,443,59526,443,allow,774099,15769,758330,743,16,223,520,1,"High deviation in pkts_sent, Bytes Received, Bytes"
64054,54778,50482,54778,allow,312,132,180,6,6,3,3,1,"High deviation in pkts_sent, NAT Destination Port, Destination Port"
60037,443,34987,443,allow,376301,13445,362856,452,102,198,254,1,"High deviation in pkts_sent, Bytes Received, Bytes"
60030,443,28456,443,allow,711172,27430,683742,812,104,342,470,1,"High deviation in pkts_sent, Bytes Received, Bytes"
55195,443,41833,443,allow,907774,32911,874863,898,460,195,703,1,"High deviation in pkts_sent, Bytes Received, Bytes"
51103,443,36898,443,allow,20280,13177,7103,82,1176,46,36,1,"High deviation in pkts_sent, Bytes Sent, Bytes"
59392,443,2075,443,allow,105190,30835,74355,372,589,169,203,1,"High deviation in pkts_sent, Bytes Sent, Bytes"
37027,443,52306,443,allow,90706,5324,85382,128,262,66,62,1,"High deviation in pkts_sent, Bytes Received, Bytes"
37031,443,21372,443,allow,43818,31519,12299,85,259,49,36,1,"High deviation in pkts_sent, Bytes Sent, Bytes"
54805,443,42817,443,allow,19635,9923,9712,165,588,72,93,1,"High deviation in pkts_sent, Bytes Sent, Bytes"
59570,443,28825,443,allow,24203,14278,9925,168,320,74,94,1,"High deviation in pkts_sent, Bytes Sent, Bytes"
57211,443,58131,443,allow,25881,12394,13487,221,579,105,116,1,"High deviation in pkts_sent, Bytes Sent, Bytes"
37965,46405,21208,46405,allow,1217,594,623,16,1764,10,6,1,"High deviation in pkts_sent, NAT Destination Port, Destination Port"
48817,48489,48817,48489,allow,480,149,331,2,1200,1,1,1,"High deviation in NAT Destination Port, Destination Port, Elapsed Time (sec)"
43480,443,57887,443,allow,58423,25600,32823,86,138,40,46,1,"High deviation in pkts_sent, Bytes Sent, Bytes"
52182,443,4685,443,allow,237151,13019,224132,251,42,90,161,1,"High deviation in pkts_sent, Bytes Received, Bytes"
56730,443,7897,443,allow,347884,9284,338600,360,31,125,235,1,"High deviation in pkts_sent, Bytes Received, Bytes"
39416,443,62311,443,allow,11188,5277,5911,95,587,44,51,1,"High deviation in pkts_sent, Bytes Sent, Bytes"
65511,443,62661,443,allow,430254,12640,417614,442,16,155,287,1,"High deviation in pkts_sent, Bytes Received, Bytes"
52096,55854,62191,55854,allow,70,70,0,1,5,1,0,1,"High deviation in NAT Destination Port, Destination Port, NAT Source Port"
43750,443,22954,443,allow,248384,70243,178141,544,588,246,298,1,"High deviation in pkts_sent, Bytes Sent, Bytes"
41011,443,63172,443,allow,175097,9838,165259,244,106,120,124,1,"High deviation in pkts_sent, Bytes Received, Bytes"
65510,443,47071,443,allow,92101,4799,87302,107,16,43,64,1,"High deviation in pkts_sent, Bytes Received, Bytes"
56313,443,7717,443,allow,37465,18615,18850,299,588,135,164,1,"High deviation in pkts_sent, Bytes Sent, Bytes"
60020,443,30222,443,allow,495428,22440,472988,692,106,316,376,1,"High deviation in pkts_sent, Bytes Received, Bytes"
56664,443,64784,443,allow,9160636,285656,8874980,9685,189,3160,6525,1,"High deviation in pkts_sent, Bytes Received, Bytes"
50584,51413,3341,51413,allow,475,150,325,2,1200,1,1,1,"High deviation in NAT Destination Port, Destination Port, Elapsed Time (sec)"
54117,443,30153,443,allow,661695,28430,633265,779,118,335,444,1,"High deviation in pkts_sent, Bytes Received, Bytes"
51824,443,65512,443,allow,10841,6594,4247,75,585,37,38,1,"High deviation in pkts_sent, Bytes Sent, Bytes"
51667,25826,2987,25826,allow,9440,9440,0,11,30,11,0,1,"High deviation in pkts_sent, NAT Destination Port, Bytes Sent"
37569,443,62296,443,allow,97539,6936,90603,160,597,74,86,1,"High deviation in pkts_sent, Bytes Received, Bytes"
44847,42103,11973,42103,allow,502,150,352,2,1200,1,1,1,"High deviation in NAT Destination Port, Destination Port, Elapsed Time (sec)"
55877,64536,41597,64536,allow,469,150,319,2,1200,1,1,1,"High deviation in NAT Destination Port, Destination Port, Elapsed Time (sec)"
59068,443,48115,443,allow,11182,6150,5032,65,1775,41,24,1,"High deviation in pkts_sent, Bytes Sent, Elapsed Time (sec)"
36400,443,31590,443,allow,53365,28404,24961,565,753,302,263,1,"High deviation in pkts_sent, Bytes Sent, Packets"
54125,443,18046,443,allow,170665,9296,161369,227,116,102,125,1,"High deviation in pkts_sent, Bytes Received, Bytes"
53347,443,16972,443,allow,21456,6153,15303,120,491,46,74,1,"High deviation in pkts_sent, Bytes Sent, Bytes"
49332,443,44143,443,allow,142684,5997,136687,134,48,31,103,1,"High deviation in pkts_sent, Bytes Received, Bytes"
48817,41768,48817,41768,allow,511,152,359,2,1200,1,1,1,"High deviation in NAT Destination Port, Destination Port, Elapsed Time (sec)"
49154,443,24167,443,allow,3163100,158133,3004967,3863,264,1464,2399,1,"High deviation in pkts_sent, Bytes Received, Bytes"
15503,50321,53712,50321,allow,490,149,341,2,1200,1,1,1,"High deviation in NAT Destination Port, Destination Port, Elapsed Time (sec)"
54118,443,28446,443,allow,115373,6904,108469,171,117,87,84,1,"High deviation in pkts_sent, Bytes Received, Bytes"
64022,60918,60664,60918,allow,70,70,0,1,4,1,0,1,"High deviation in NAT Destination Port, Destination Port, NAT Source Port"
50824,80,46115,80,allow,36051,11695,24356,109,265,55,54,1,"High deviation in pkts_sent, Bytes Sent, Bytes"
54627,443,30890,443,allow,182017,6621,175396,189,181,55,134,1,"High deviation in pkts_sent, Bytes Received, Bytes"
50827,80,8180,80,allow,35970,11674,24296,108,265,55,53,1,"High deviation in pkts_sent, Bytes Sent, Bytes"
50825,80,41226,80,allow,35970,11674,24296,108,265,55,53,1,"High deviation in pkts_sent, Bytes Sent, Bytes"
54127,443,25652,443,allow,148422,10568,137854,223,115,114,109,1,"High deviation in pkts_sent, Bytes Received, Bytes"
54126,443,11328,443,allow,147104,9481,137623,217,115,111,106,1,"High deviation in pkts_sent, Bytes Received, Bytes"
38460,443,18587,443,allow,14768,3347,11421,69,1902,32,37,1,"High deviation in pkts_sent, Bytes Received, Bytes"
50826,80,48832,80,allow,35970,11674,24296,108,265,55,53,1,"High deviation in pkts_sent, Bytes Sent, Bytes"
49213,443,9169,443,allow,157994,4952,153042,186,255,68,118,1,"High deviation in pkts_sent, Bytes Received, Bytes"
53164,48198,7411,48198,allow,320,140,180,6,7,3,3,1,"High deviation in pkts_sent, NAT Destination Port, Destination Port"
52121,58933,17101,58933,allow,70,70,0,2,8,2,0,1,"High deviation in pkts_sent, NAT Destination Port, Destination Port"
54054,443,10549,443,allow,34629391,1109219,33520172,36863,278,12240,24623,1,"High deviation in pkts_sent, Bytes Received, Bytes"
49327,443,21395,443,allow,116686,4968,111718,116,53,31,85,1,"High deviation in pkts_sent, Bytes Received, Bytes"
30960,45755,44633,45755,allow,462,462,0,8,3631,8,0,1,"High deviation in pkts_sent, NAT Destination Port, Elapsed Time (sec)"
48817,29614,48817,29614,allow,506,152,354,2,1201,1,1,1,"High deviation in NAT Destination Port, Elapsed Time (sec), Destination Port"
48817,23944,48817,23944,allow,513,152,361,2,1201,1,1,1,"High deviation in NAT Destination Port, Elapsed Time (sec), Destination Port"
39434,5228,17809,5228,allow,3505,2006,1499,30,3744,15,15,1,"High deviation in pkts_sent, Elapsed Time (sec), NAT Destination Port"
62722,443,49389,443,allow,3491257,62261,3428996,3146,155,768,2378,1,"High deviation in pkts_sent, Bytes Received, Bytes"
41322,443,6156,443,allow,994089,30018,964071,1058,350,373,685,1,"High deviation in pkts_sent, Bytes Received, Bytes"
10063,443,38761,443,allow,822903,35544,787359,1068,153,463,605,1,"High deviation in pkts_sent, Bytes Received, Bytes"
38922,443,18971,443,allow,346170,16091,330079,454,16,225,229,1,"High deviation in pkts_sent, Bytes Received, Bytes"
52247,443,52247,443,allow,948720,23674,925046,988,26,349,639,1,"High deviation in pkts_sent, Bytes Received, Bytes"
62721,443,47170,443,allow,5718309,117049,5601260,5287,155,1390,3897,1,"High deviation in pkts_sent, Bytes Received, Bytes"
46056,443,52673,443,allow,80200,69062,11138,193,89,100,93,1,"High deviation in pkts_sent, Bytes Sent, Bytes"
57590,80,57590,80,allow,1165239,13055,1152184,977,149,193,784,1,"High deviation in pkts_sent, Bytes Received, Bytes"
51221,57073,10928,57073,allow,481,150,331,2,1200,1,1,1,"High deviation in NAT Destination Port, Destination Port, Elapsed Time (sec)"
48817,45919,48817,45919,allow,334,158,176,2,1200,1,1,1,"High deviation in NAT Destination Port, Destination Port, Elapsed Time (sec)"
10151,40231,24979,40231,allow,481,150,331,2,1200,1,1,1,"High deviation in NAT Destination Port, Destination Port, Elapsed Time (sec)"
52253,443,52253,443,allow,429263,14390,414873,449,24,159,290,1,"High deviation in pkts_sent, Bytes Received, Bytes"
55858,80,7371,80,allow,104399,8436,95963,122,21,49,73,1,"High deviation in pkts_sent, Bytes Received, Bytes"
41906,443,20652,443,allow,181961,40579,141382,247,238,101,146,1,"High deviation in pkts_sent, Bytes Received, Bytes"
56281,443,8565,443,allow,22352,9825,12527,111,370,55,56,1,"High deviation in pkts_sent, Bytes Sent, Bytes"
19473,28867,41961,28867,allow,480,149,331,2,1200,1,1,1,"High deviation in NAT Destination Port, Elapsed Time (sec), Destination Port"
47825,443,54151,443,allow,932130,36511,895619,1142,167,465,677,1,"High deviation in pkts_sent, Bytes Received, Bytes"
52114,64853,12974,64853,allow,70,70,0,2,8,2,0,1,"High deviation in pkts_sent, NAT Destination Port, Destination Port"
52116,64692,45907,64692,allow,70,70,0,2,8,2,0,1,"High deviation in pkts_sent, NAT Destination Port, Destination Port"
34225,443,33698,443,allow,256793,17776,239017,327,23,146,181,1,"High deviation in pkts_sent, Bytes Received, Bytes"
6881,13487,50124,13487,allow,228,118,110,2,1199,1,1,1,"High deviation in NAT Destination Port, Elapsed Time (sec), Destination Port"
39817,443,13115,443,allow,516080,28328,487752,660,95,305,355,1,"High deviation in pkts_sent, Bytes Received, Bytes"
56628,443,8752,443,allow,6654,3821,2833,60,3037,30,30,1,"High deviation in pkts_sent, Elapsed Time (sec), Bytes Sent"
64120,443,47176,443,allow,3767437,87322,3680115,3675,52,1230,2445,1,"High deviation in pkts_sent, Bytes Received, Bytes"
6881,25649,11591,25649,allow,509,150,359,2,1200,1,1,1,"High deviation in NAT Destination Port, Elapsed Time (sec), Destination Port"
63654,443,35757,443,allow,9152483,314975,8837508,9599,206,3195,6404,1,"High deviation in pkts_sent, Bytes Received, Bytes"
52109,60841,37568,60841,allow,258,70,188,4,8,2,2,1,"High deviation in pkts_sent, NAT Destination Port, Destination Port"
61433,443,33532,443,allow,41274,18956,22318,90,171,43,47,1,"High deviation in pkts_sent, Bytes Sent, Bytes"
58872,443,51853,443,allow,342665,10261,332404,369,90,117,252,1,"High deviation in pkts_sent, Bytes Received, Bytes"
52376,443,24814,443,allow,33906,25094,8812,63,447,36,27,1,"High deviation in pkts_sent, Bytes Sent, Bytes"
30960,45763,2134,45763,allow,330,330,0,6,3609,6,0,1,"High deviation in pkts_sent, NAT Destination Port, Elapsed Time (sec)"
30960,45752,44974,45752,allow,462,462,0,8,3631,8,0,1,"High deviation in pkts_sent, NAT Destination Port, Elapsed Time (sec)"
56470,28678,7618,28678,allow,1806,1806,0,22,224,22,0,1,"High deviation in pkts_sent, NAT Destination Port, Destination Port"
38705,443,49826,443,allow,1248170,26899,1221271,1212,16,382,830,1,"High deviation in pkts_sent, Bytes Received, Bytes"
57343,443,46945,443,allow,1607664,53945,1553719,1792,39,700,1092,1,"High deviation in pkts_sent, Bytes Received, Bytes"
35973,443,21497,443,allow,4665045,113088,4551957,4511,421,1285,3226,1,"High deviation in pkts_sent, Bytes Received, Bytes"
48817,50321,48817,50321,allow,334,158,176,2,1203,1,1,1,"High deviation in NAT Destination Port, Destination Port, Elapsed Time (sec)"
50286,443,48730,443,allow,6414386,102255,6312131,5812,182,1634,4178,1,"High deviation in pkts_sent, Bytes Received, Bytes"
22,44840,22,44840,allow,1427,1170,257,8,15,4,4,1,"High deviation in pkts_sent, NAT Destination Port, Destination Port"
21133,54508,26359,54508,allow,323,150,173,2,1199,1,1,1,"High deviation in NAT Destination Port, Destination Port, Elapsed Time (sec)"
52925,443,2164,443,allow,114867,4243,110624,128,120,44,84,1,"High deviation in pkts_sent, Bytes Received, Bytes"
53159,58710,30090,58710,allow,698,320,378,10,18,6,4,1,"High deviation in pkts_sent, NAT Destination Port, Destination Port"
35999,443,44617,443,allow,670261,26523,643738,728,188,262,466,1,"High deviation in pkts_sent, Bytes Received, Bytes"
65375,443,53764,443,allow,2458316,102393,2355923,2942,241,1261,1681,1,"High deviation in pkts_sent, Bytes Received, Bytes"
53865,64000,37089,64000,allow,492,306,186,8,15,5,3,1,"High deviation in pkts_sent, NAT Destination Port, Destination Port"
56275,443,61048,443,allow,513682,20015,493667,523,226,126,397,1,"High deviation in pkts_sent, Bytes Received, Bytes"
53867,60272,36955,60272,allow,70,70,0,1,5,1,0,1,"High deviation in NAT Destination Port, Destination Port, NAT Source Port"
44162,80,44162,80,allow,457843,10253,447590,452,26,152,300,1,"High deviation in pkts_sent, Bytes Received, Bytes"
50265,49893,64996,49893,allow,480,149,331,2,1200,1,1,1,"High deviation in NAT Destination Port, Destination Port, Elapsed Time (sec)"
58871,443,24562,443,allow,405189,13572,391617,446,89,155,291,1,"High deviation in pkts_sent, Bytes Received, Bytes"
54542,443,54542,443,allow,150554,18764,131790,192,117,95,97,1,"High deviation in pkts_sent, Bytes Received, Bytes"
59952,80,58096,80,allow,440081,8465,431616,424,24,137,287,1,"High deviation in pkts_sent, Bytes Received, Bytes"
59964,443,4370,443,allow,48525,4928,43597,111,660,55,56,1,"High deviation in pkts_sent, Bytes Received, Bytes"
45230,443,23452,443,allow,33924,26047,7877,73,403,33,40,1,"High deviation in pkts_sent, Bytes Sent, Bytes"
48817,57451,48817,57451,allow,152,152,0,1,1200,1,0,1,"High deviation in NAT Destination Port, Destination Port, Elapsed Time (sec)"
56230,5228,8322,5228,allow,2564,1546,1018,18,3600,9,9,1,"High deviation in pkts_sent, Elapsed Time (sec), NAT Destination Port"
32805,443,65246,443,allow,438124,21529,416595,481,398,138,343,1,"High deviation in pkts_sent, Bytes Received, Bytes"
30188,51419,27819,51419,allow,502,150,352,2,1200,1,1,1,"High deviation in NAT Destination Port, Destination Port, Elapsed Time (sec)"
50474,443,49167,443,allow,17449456,390704,17058752,16816,383,4917,11899,1,"High deviation in pkts_sent, Bytes Received, Bytes"
50584,51413,41920,51413,allow,475,150,325,2,1200,1,1,1,"High deviation in NAT Destination Port, Destination Port, Elapsed Time (sec)"
41501,80,33952,80,allow,306627,58973,247654,556,297,246,310,1,"High deviation in pkts_sent, Bytes Received, Bytes"
57832,443,1165,443,allow,91134,7506,83628,132,130,52,80,1,"High deviation in pkts_sent, Bytes Received, Bytes"
48817,36292,48817,36292,allow,519,158,361,2,1200,1,1,1,"High deviation in NAT Destination Port, Destination Port, Elapsed Time (sec)"
65507,443,3045,443,allow,453047,13340,439707,469,16,165,304,1,"High deviation in pkts_sent, Bytes Received, Bytes"
50469,443,45578,443,allow,19063941,342071,18721870,17124,384,4119,13005,1,"High deviation in pkts_sent, Bytes Received, Bytes"
62246,443,21397,443,allow,117314,4775,112539,144,120,51,93,1,"High deviation in pkts_sent, Bytes Received, Bytes"
37965,63728,43778,63728,allow,1294,594,700,20,1781,10,10,1,"High deviation in pkts_sent, NAT Destination Port, Destination Port"
35991,443,8225,443,allow,2509208,64544,2444664,2429,304,700,1729,1,"High deviation in pkts_sent, Bytes Received, Bytes"
48854,443,38265,443,allow,2497156,63601,2433555,2465,17,852,1613,1,"High deviation in pkts_sent, Bytes Received, Bytes"
52252,443,52252,443,allow,221672,9306,212366,249,21,97,152,1,"High deviation in pkts_sent, Bytes Received, Bytes"
65508,443,2648,443,allow,92884,4939,87945,111,16,45,66,1,"High deviation in pkts_sent, Bytes Received, Bytes"
38130,443,8733,443,allow,717020,36766,680254,939,60,449,490,1,"High deviation in pkts_sent, Bytes Received, Bytes"
50482,443,33515,443,allow,6904692,144860,6759832,6483,140,1783,4700,1,"High deviation in pkts_sent, Bytes Received, Bytes"
52112,53559,37444,53559,allow,316,136,180,6,6,3,3,1,"High deviation in pkts_sent, NAT Destination Port, Destination Port"
54503,443,54503,443,allow,157452,26878,130574,213,214,111,102,1,"High deviation in pkts_sent, Bytes Received, Bytes"
58685,443,52844,443,allow,165763,5072,160691,181,120,61,120,1,"High deviation in pkts_sent, Bytes Received, Bytes"
52250,443,52250,443,allow,162355,8745,153610,178,22,66,112,1,"High deviation in pkts_sent, Bytes Received, Bytes"
61417,443,25149,443,allow,652760,608740,44020,734,432,496,238,1,"High deviation in pkts_sent, Bytes Sent, Bytes"
52329,443,64562,443,allow,294025,14919,279106,401,42,192,209,1,"High deviation in pkts_sent, Bytes Received, Bytes"
60480,60519,7495,60519,allow,320,140,180,6,8,3,3,1,"High deviation in pkts_sent, NAT Destination Port, Destination Port"
59985,443,35984,443,allow,55132,17147,37985,126,150,55,71,1,"High deviation in pkts_sent, Bytes Sent, Bytes"
54061,443,17849,443,allow,126027,103934,22093,380,239,237,143,1,"High deviation in pkts_sent, Bytes Sent, Bytes"
45565,443,30523,443,allow,1784491,72960,1711531,1872,113,687,1185,1,"High deviation in pkts_sent, Bytes Received, Bytes"
52094,443,49643,443,allow,3296065,47110,3248955,2746,51,533,2213,1,"High deviation in pkts_sent, Bytes Received, Bytes"
53853,39723,8770,39723,allow,1890,1010,880,13,16,8,5,1,"High deviation in pkts_sent, NAT Destination Port, Destination Port"
42305,443,8617,443,allow,1262512,53286,1209226,1457,280,548,909,1,"High deviation in pkts_sent, Bytes Received, Bytes"
52249,443,52249,443,allow,152755,7304,145451,171,21,65,106,1,"High deviation in pkts_sent, Bytes Received, Bytes"
50728,443,61192,443,allow,34661,17810,16851,89,119,40,49,1,"High deviation in pkts_sent, Bytes Sent, Bytes"
52066,60118,49058,60118,allow,70,70,0,1,5,1,0,1,"High deviation in NAT Destination Port, Destination Port, NAT Source Port"
36499,443,51972,443,allow,1159756,1123031,36725,1206,26,753,453,1,"High deviation in pkts_sent, Bytes Sent, Bytes"
42306,443,42899,443,allow,449862,38989,410873,644,280,286,358,1,"High deviation in pkts_sent, Bytes Received, Bytes"
42308,443,54120,443,allow,433261,34730,398531,604,279,258,346,1,"High deviation in pkts_sent, Bytes Received, Bytes"
6881,61404,13734,61404,allow,228,118,110,2,1200,1,1,1,"High deviation in NAT Destination Port, Destination Port, Elapsed Time (sec)"
48020,443,61756,443,allow,33481,5635,27846,73,287,32,41,1,"High deviation in pkts_sent, Bytes Received, Bytes"
64651,443,22018,443,allow,317618,11688,305930,350,164,118,232,1,"High deviation in pkts_sent, Bytes Received, Bytes"
57470,61467,29646,61467,allow,479,150,329,2,1199,1,1,1,"High deviation in NAT Destination Port, Destination Port, Elapsed Time (sec)"
38857,443,38857,443,allow,115031,5628,109403,143,104,55,88,1,"High deviation in pkts_sent, Bytes Received, Bytes"
51410,443,1294,443,allow,619870,220857,399013,1045,123,531,514,1,"High deviation in pkts_sent, Bytes Sent, Bytes"
38858,443,38858,443,allow,226465,10306,216159,292,104,135,157,1,"High deviation in pkts_sent, Bytes Received, Bytes"
57577,80,57577,80,allow,172548,4355,168193,172,148,53,119,1,"High deviation in pkts_sent, Bytes Received, Bytes"
49749,80,64733,80,allow,230959,4381,226578,217,91,60,157,1,"High deviation in pkts_sent, Bytes Received, Bytes"
30960,45762,15257,45762,allow,330,330,0,6,3609,6,0,1,"High deviation in pkts_sent, NAT Destination Port, Elapsed Time (sec)"
57978,5228,59102,5228,allow,2725,1610,1115,20,3600,10,10,1,"High deviation in pkts_sent, Elapsed Time (sec), NAT Destination Port"
48817,32794,48817,32794,allow,152,152,0,1,1200,1,0,1,"High deviation in NAT Destination Port, Destination Port, Elapsed Time (sec)"
38861,443,38861,443,allow,90303,5838,84465,140,103,68,72,1,"High deviation in pkts_sent, Bytes Received, Bytes"
57587,80,57587,80,allow,218150,5323,212827,218,145,69,149,1,"High deviation in pkts_sent, Bytes Received, Bytes"
64022,60918,37297,60918,allow,66,66,0,2,7,2,0,1,"High deviation in pkts_sent, NAT Destination Port, Destination Port"
49222,443,64126,443,allow,476852,12774,464078,491,17,177,314,1,"High deviation in pkts_sent, Bytes Received, Bytes"
56360,443,55866,443,allow,188316,24744,163572,302,172,119,183,1,"High deviation in pkts_sent, Bytes Received, Bytes"
57591,80,57591,80,allow,144228,2522,141706,135,144,36,99,1,"High deviation in pkts_sent, Bytes Received, Bytes"
49160,16767,65061,16767,allow,854,150,704,4,1200,2,2,1,"High deviation in pkts_sent, NAT Destination Port, Elapsed Time (sec)"
50265,57799,36521,57799,allow,1450,747,703,16,1200,9,7,1,"High deviation in pkts_sent, NAT Destination Port, Destination Port"
55063,5223,9362,5223,allow,4336,1518,2818,23,3002,14,9,1,"High deviation in pkts_sent, Elapsed Time (sec), NAT Destination Port"
37965,63666,47723,63666,allow,10717,6715,4002,121,4588,71,50,1,"High deviation in pkts_sent, NAT Destination Port, Elapsed Time (sec)"
55877,56299,54578,56299,allow,481,150,331,2,1200,1,1,1,"High deviation in NAT Destination Port, Destination Port, Elapsed Time (sec)"
51412,443,35247,443,allow,200230,8733,191497,250,122,106,144,1,"High deviation in pkts_sent, Bytes Received, Bytes"
37336,443,19104,443,allow,995086,50081,945005,1281,216,515,766,1,"High deviation in pkts_sent, Bytes Received, Bytes"
60470,51413,5081,51413,allow,741,435,306,10,16,5,5,1,"High deviation in pkts_sent, NAT Destination Port, Destination Port"
49655,80,10831,80,allow,6485767,147003,6338764,6221,320,2024,4197,1,"High deviation in pkts_sent, Bytes Received, Bytes"
52138,443,52138,443,allow,80933,20860,60073,121,324,66,55,1,"High deviation in pkts_sent, Bytes Sent, Bytes"
56528,443,48835,443,allow,158084,6138,151946,173,95,64,109,1,"High deviation in pkts_sent, Bytes Received, Bytes"
6881,51413,48817,51413,allow,200,111,89,2,1200,1,1,1,"High deviation in NAT Destination Port, Destination Port, Elapsed Time (sec)"
39717,5228,64597,5228,allow,7587,2099,5488,26,3602,14,12,1,"High deviation in pkts_sent, Elapsed Time (sec), NAT Destination Port"
52062,60388,22555,60388,allow,70,70,0,1,5,1,0,1,"High deviation in NAT Destination Port, Destination Port, NAT Source Port"
64024,57825,29804,57825,allow,312,132,180,6,6,3,3,1,"High deviation in pkts_sent, NAT Destination Port, Destination Port"
55694,62954,52341,62954,allow,504,318,186,8,15,5,3,1,"High deviation in pkts_sent, NAT Destination Port, Destination Port"
55696,64301,60133,64301,allow,316,190,126,5,15,3,2,1,"High deviation in pkts_sent, NAT Destination Port, Destination Port"
52092,48658,51084,48658,allow,316,136,180,6,7,3,3,1,"High deviation in pkts_sent, NAT Destination Port, Destination Port"
53076,443,8791,443,allow,96850,6037,90813,150,177,55,95,1,"High deviation in pkts_sent, Bytes Received, Bytes"
54749,443,23422,443,allow,273283,194709,78574,1567,3312,746,821,1,"High deviation in pkts_sent, Bytes Sent, Bytes"
51175,443,19417,443,allow,2132473,55149,2077324,2144,63,731,1413,1,"High deviation in pkts_sent, Bytes Received, Bytes"
42066,443,21363,443,allow,377544,10569,366975,414,221,152,262,1,"High deviation in pkts_sent, Bytes Received, Bytes"
53848,43725,33158,43725,allow,552,306,246,9,15,5,4,1,"High deviation in pkts_sent, NAT Destination Port, Destination Port"
57833,443,7309,443,allow,215996,13055,202941,265,127,96,169,1,"High deviation in pkts_sent, Bytes Received, Bytes"
6881,6992,61749,6992,allow,150,150,0,1,1200,1,0,1,"High deviation in NAT Destination Port, Elapsed Time (sec), Destination Port"
52136,443,52136,443,allow,298081,63335,234746,337,323,145,192,1,"High deviation in pkts_sent, Bytes Received, Bytes"
50461,443,13300,443,allow,78333,12774,65559,140,128,59,81,1,"High deviation in pkts_sent, Bytes Received, Bytes"
57470,50321,60490,50321,allow,5231,5231,0,79,5173,79,0,1,"High deviation in pkts_sent, NAT Destination Port, Elapsed Time (sec)"
15503,55878,37795,55878,allow,481,150,331,2,1200,1,1,1,"High deviation in NAT Destination Port, Destination Port, Elapsed Time (sec)"
49236,443,49236,443,allow,554853,293345,261508,600,69,317,283,1,"High deviation in pkts_sent, Bytes Sent, Bytes"
48817,46429,48817,46429,allow,763,296,467,4,1200,2,2,1,"High deviation in pkts_sent, NAT Destination Port, Destination Port"
53146,443,41053,443,allow,29874004,955051,28918953,31844,303,10580,21264,1,"High deviation in pkts_sent, Bytes Received, Bytes"
48817,33028,48817,33028,allow,152,152,0,1,1200,1,0,1,"High deviation in NAT Destination Port, Destination Port, Elapsed Time (sec)"
48817,27003,48817,27003,allow,839,296,543,4,1200,2,2,1,"High deviation in pkts_sent, NAT Destination Port, Elapsed Time (sec)"
45184,5228,38008,5228,allow,9107,2358,6749,24,3600,13,11,1,"High deviation in pkts_sent, Elapsed Time (sec), NAT Destination Port"
56221,443,24462,443,allow,129824,16359,113465,185,459,79,106,1,"High deviation in pkts_sent, Bytes Received, Bytes"
56490,443,32124,443,allow,163763,5320,158443,178,120,60,118,1,"High deviation in pkts_sent, Bytes Received, Bytes"
48817,47005,48817,47005,allow,158,158,0,1,1200,1,0,1,"High deviation in NAT Destination Port, Destination Port, Elapsed Time (sec)"
50986,443,50781,443,allow,67798,17043,50755,202,146,110,92,1,"High deviation in pkts_sent, Bytes Sent, Bytes"
51221,65427,56298,65427,allow,460,150,310,2,1200,1,1,1,"High deviation in NAT Destination Port, Destination Port, Elapsed Time (sec)"
57913,443,45296,443,allow,9578079,276384,9301695,9817,153,2984,6833,1,"High deviation in pkts_sent, Bytes Received, Bytes"
50439,80,50439,80,allow,96018,5956,90062,107,20,41,66,1,"High deviation in pkts_sent, Bytes Received, Bytes"
45289,80,45289,80,allow,144717,5580,139137,180,20,81,99,1,"High deviation in pkts_sent, Bytes Received, Bytes"
38702,443,49260,443,allow,1117339,17881,1099458,1006,16,256,750,1,"High deviation in pkts_sent, Bytes Received, Bytes"
48817,63615,48817,63615,allow,765,296,469,4,1200,2,2,1,"High deviation in pkts_sent, NAT Destination Port, Destination Port"
53162,60352,25976,60352,allow,70,70,0,2,8,2,0,1,"High deviation in pkts_sent, NAT Destination Port, Destination Port"
37569,443,55677,443,allow,120566,15345,105221,173,125,72,101,1,"High deviation in pkts_sent, Bytes Received, Bytes"
48817,32897,48817,32897,allow,152,152,0,1,1200,1,0,1,"High deviation in NAT Destination Port, Destination Port, Elapsed Time (sec)"
56712,443,43897,443,allow,1540037,36876,1503161,1511,62,511,1000,1,"High deviation in pkts_sent, Bytes Received, Bytes"
65506,443,5450,443,allow,92243,4519,87724,105,16,39,66,1,"High deviation in pkts_sent, Bytes Received, Bytes"
60469,60092,63327,60092,allow,70,70,0,1,5,1,0,1,"High deviation in NAT Destination Port, Destination Port, NAT Source Port"
63848,80,63848,80,allow,555419,4827,550592,451,21,64,387,1,"High deviation in pkts_sent, Bytes Received, Bytes"
36621,443,53395,443,allow,2239099,75601,2163498,2512,71,983,1529,1,"High deviation in pkts_sent, Bytes Received, Bytes"
52164,443,1593,443,allow,161883,8848,153035,177,54,64,113,1,"High deviation in pkts_sent, Bytes Received, Bytes"
19473,40959,26703,40959,allow,491,150,341,2,1200,1,1,1,"High deviation in NAT Destination Port, Destination Port, Elapsed Time (sec)"
62345,443,13195,443,allow,6343025,74037,6268988,5018,58,765,4253,1,"High deviation in pkts_sent, Bytes Received, Bytes"
65505,443,12963,443,allow,458741,13270,445471,469,16,164,305,1,"High deviation in pkts_sent, Bytes Received, Bytes"
48817,57013,48817,57013,allow,158,158,0,1,1200,1,0,1,"High deviation in NAT Destination Port, Destination Port, Elapsed Time (sec)"
49656,443,4978,443,allow,182624,7130,175494,212,132,77,135,1,"High deviation in pkts_sent, Bytes Received, Bytes"
45908,443,37140,443,allow,507235,15454,491781,534,136,188,346,1,"High deviation in pkts_sent, Bytes Received, Bytes"
30188,49786,29335,49786,allow,502,150,352,2,1200,1,1,1,"High deviation in NAT Destination Port, Destination Port, Elapsed Time (sec)"
53867,60272,19562,60272,allow,70,70,0,2,8,2,0,1,"High deviation in pkts_sent, NAT Destination Port, Destination Port"
56714,443,11426,443,allow,579769,15036,564733,578,61,199,379,1,"High deviation in pkts_sent, Bytes Received, Bytes"
53880,61393,8542,61393,allow,320,140,180,6,6,3,3,1,"High deviation in pkts_sent, NAT Destination Port, Destination Port"
49304,443,52179,443,allow,932965,16289,916676,768,65,148,620,1,"High deviation in pkts_sent, Bytes Received, Bytes"
48817,45682,48817,45682,allow,513,152,361,2,1200,1,1,1,"High deviation in NAT Destination Port, Destination Port, Elapsed Time (sec)"
48817,42099,48817,42099,allow,479,152,327,2,1200,1,1,1,"High deviation in NAT Destination Port, Destination Port, Elapsed Time (sec)"
48817,49490,48817,49490,allow,513,152,361,2,1200,1,1,1,"High deviation in NAT Destination Port, Destination Port, Elapsed Time (sec)"
48817,51413,48817,51413,allow,479,152,327,2,1200,1,1,1,"High deviation in NAT Destination Port, Destination Port, Elapsed Time (sec)"
48817,51413,48817,51413,allow,479,152,327,2,1200,1,1,1,"High deviation in NAT Destination Port, Destination Port, Elapsed Time (sec)"
48817,49157,48817,49157,allow,328,152,176,2,1200,1,1,1,"High deviation in NAT Destination Port, Destination Port, Elapsed Time (sec)"
48817,63838,48817,63838,allow,513,152,361,2,1200,1,1,1,"High deviation in NAT Destination Port, Destination Port, Elapsed Time (sec)"
48817,37028,48817,37028,allow,513,152,361,2,1200,1,1,1,"High deviation in NAT Destination Port, Destination Port, Elapsed Time (sec)"
48817,26484,48817,26484,allow,513,152,361,2,1200,1,1,1,"High deviation in NAT Destination Port, Elapsed Time (sec), Destination Port"
48817,51413,48817,51413,allow,479,152,327,2,1200,1,1,1,"High deviation in NAT Destination Port, Destination Port, Elapsed Time (sec)"
48817,41706,48817,41706,allow,513,152,361,2,1200,1,1,1,"High deviation in NAT Destination Port, Destination Port, Elapsed Time (sec)"
56698,80,23963,80,allow,176644,9435,167209,266,65,104,162,1,"High deviation in pkts_sent, Bytes Received, Bytes"
52071,57491,41650,57491,allow,70,70,0,2,8,2,0,1,"High deviation in pkts_sent, NAT Destination Port, Destination Port"
39114,443,44592,443,allow,1238821,42695,1196126,1389,72,535,854,1,"High deviation in pkts_sent, Bytes Received, Bytes"
57778,443,43252,443,allow,6182,3879,2303,53,3828,31,22,1,"High deviation in pkts_sent, Elapsed Time (sec), Bytes Sent"
42457,5222,64493,5222,allow,35380,2898,32482,63,227,22,41,1,"High deviation in pkts_sent, Bytes Received, Bytes"
55520,443,13062,443,allow,272841,13586,259255,353,176,164,189,1,"High deviation in pkts_sent, Bytes Received, Bytes"
37965,6224,9493,6224,allow,38098,12284,25814,207,2433,100,107,1,"High deviation in pkts_sent, Bytes Sent, Bytes"
52074,57947,10118,57947,allow,70,70,0,2,8,2,0,1,"High deviation in pkts_sent, NAT Destination Port, Destination Port"
55020,443,50900,443,allow,670633,656612,14021,657,146,465,192,1,"High deviation in pkts_sent, Bytes Sent, Bytes"
8283,52443,34417,52443,allow,130,70,60,2,30,1,1,1,"High deviation in NAT Destination Port, Destination Port, Source Port"
48817,60483,48817,60483,allow,519,158,361,2,1199,1,1,1,"High deviation in NAT Destination Port, Destination Port, Elapsed Time (sec)"
48817,39388,48817,39388,allow,1267,631,636,6,1199,3,3,1,"High deviation in pkts_sent, NAT Destination Port, Destination Port"
48817,51413,48817,51413,allow,485,158,327,2,1199,1,1,1,"High deviation in NAT Destination Port, Destination Port, Elapsed Time (sec)"
48817,51234,48817,51234,allow,158,158,0,1,1200,1,0,1,"High deviation in NAT Destination Port, Destination Port, Elapsed Time (sec)"
52888,5223,32740,5223,allow,12302,5509,6793,43,1061,16,27,1,"High deviation in pkts_sent, Bytes Sent, Bytes"
21133,21689,35631,21689,allow,481,150,331,2,1199,1,1,1,"High deviation in NAT Destination Port, Elapsed Time (sec), Destination Port"
48817,38081,48817,38081,allow,863,363,500,4,1200,2,2,1,"High deviation in pkts_sent, NAT Destination Port, Destination Port"
48817,51417,48817,51417,allow,485,158,327,2,1200,1,1,1,"High deviation in NAT Destination Port, Destination Port, Elapsed Time (sec)"
55453,443,3812,443,allow,3015948,160028,2855920,3852,218,1499,2353,1,"High deviation in pkts_sent, Bytes Received, Bytes"
48817,58518,48817,58518,allow,580,121,459,4,1199,2,2,1,"High deviation in pkts_sent, NAT Destination Port, Destination Port"
48817,23456,48817,23456,allow,485,158,327,2,1200,1,1,1,"High deviation in NAT Destination Port, Elapsed Time (sec), Destination Port"
61141,443,38623,443,allow,383052,17263,365789,396,132,119,277,1,"High deviation in pkts_sent, Bytes Received, Bytes"
48817,51413,48817,51413,allow,485,158,327,2,1200,1,1,1,"High deviation in NAT Destination Port, Destination Port, Elapsed Time (sec)"
52081,51835,33500,51835,allow,316,136,180,6,6,3,3,1,"High deviation in pkts_sent, NAT Destination Port, Destination Port"
50606,80,30995,80,allow,83795,22317,61478,117,43,52,65,1,"High deviation in pkts_sent, Bytes Sent, Bytes"
59366,443,63784,443,allow,59122,7352,51770,85,322,41,44,1,"High deviation in pkts_sent, Bytes Received, Bytes"
60500,443,54155,443,allow,103479,7755,95724,165,19,70,95,1,"High deviation in pkts_sent, Bytes Received, Bytes"
60065,80,60065,80,allow,246733,5745,240988,246,144,80,166,1,"High deviation in pkts_sent, Bytes Received, Bytes"
50265,56845,47720,56845,allow,480,149,331,2,1200,1,1,1,"High deviation in NAT Destination Port, Destination Port, Elapsed Time (sec)"
53152,443,33270,443,allow,116790,7062,109728,166,144,85,81,1,"High deviation in pkts_sent, Bytes Received, Bytes"
38460,443,14446,443,allow,272822,10124,262698,330,81,126,204,1,"High deviation in pkts_sent, Bytes Received, Bytes"
54022,443,20800,443,allow,121935,7839,114096,175,255,82,93,1,"High deviation in pkts_sent, Bytes Received, Bytes"
49218,443,54857,443,allow,590577,16239,574338,610,23,222,388,1,"High deviation in pkts_sent, Bytes Received, Bytes"
49497,443,34229,443,allow,185560,47806,137754,421,295,217,204,1,"High deviation in pkts_sent, Bytes Sent, Bytes"
63137,47117,19060,47117,allow,574,448,126,10,25,8,2,1,"High deviation in pkts_sent, NAT Destination Port, Destination Port"
52066,60118,24886,60118,allow,70,70,0,2,8,2,0,1,"High deviation in pkts_sent, NAT Destination Port, Destination Port"
58169,443,39268,443,allow,30845,9943,20902,172,133,73,99,1,"High deviation in pkts_sent, Bytes Sent, Bytes"
53831,54676,36346,54676,allow,492,306,186,8,16,5,3,1,"High deviation in pkts_sent, NAT Destination Port, Destination Port"
39802,443,46895,443,allow,2863801,103667,2760134,3193,182,1240,1953,1,"High deviation in pkts_sent, Bytes Received, Bytes"
53842,57861,18155,57861,allow,492,306,186,8,14,5,3,1,"High deviation in pkts_sent, NAT Destination Port, Destination Port"
49160,51413,36529,51413,allow,800,150,650,4,1200,2,2,1,"High deviation in pkts_sent, NAT Destination Port, Destination Port"
35459,443,23832,443,allow,119911,5690,114221,153,173,63,90,1,"High deviation in pkts_sent, Bytes Received, Bytes"
61830,443,61830,443,allow,88574,15708,72866,114,176,52,62,1,"High deviation in pkts_sent, Bytes Received, Bytes"
57470,37395,27238,37395,allow,1566,332,1234,11,1199,5,6,1,"High deviation in pkts_sent, NAT Destination Port, Destination Port"
52070,55946,25301,55946,allow,316,136,180,6,7,3,3,1,"High deviation in pkts_sent, NAT Destination Port, Destination Port"
61827,443,61827,443,allow,56634,10853,45781,76,175,34,42,1,"High deviation in pkts_sent, Bytes Received, Bytes"
61831,443,61831,443,allow,530764,27638,503126,528,175,179,349,1,"High deviation in pkts_sent, Bytes Received, Bytes"
57470,26944,61791,26944,allow,480,149,331,2,1200,1,1,1,"High deviation in NAT Destination Port, Elapsed Time (sec), Destination Port"
57470,17690,10017,17690,allow,1818,1188,630,26,2804,19,7,1,"High deviation in pkts_sent, NAT Destination Port, Elapsed Time (sec)"
15503,23852,58898,23852,allow,10840,6789,4051,143,4379,82,61,1,"High deviation in pkts_sent, NAT Destination Port, Elapsed Time (sec)"
61826,443,61826,443,allow,95212,17857,77355,119,175,53,66,1,"High deviation in pkts_sent, Bytes Received, Bytes"
54948,443,58033,443,allow,493685,14728,478957,612,316,213,399,1,"High deviation in pkts_sent, Bytes Received, Bytes"
52046,59791,21148,59791,allow,70,70,0,1,4,1,0,1,"High deviation in NAT Destination Port, Destination Port, NAT Source Port"
49165,5938,24586,5938,allow,143727,72050,71677,1106,10824,655,451,1,"High deviation in pkts_sent, Bytes Sent, Bytes"
34911,443,4016,443,allow,414843,13933,400910,459,136,160,299,1,"High deviation in pkts_sent, Bytes Received, Bytes"
50151,80,25475,80,allow,1915831,46544,1869287,1569,166,311,1258,1,"High deviation in pkts_sent, Bytes Received, Bytes"
60466,64337,26945,64337,allow,70,70,0,1,5,1,0,1,"High deviation in NAT Destination Port, Destination Port, NAT Source Port"
47828,443,14141,443,allow,143399,8522,134877,208,153,101,107,1,"High deviation in pkts_sent, Bytes Received, Bytes"
41332,80,41332,80,allow,230861,5063,225798,227,18,74,153,1,"High deviation in pkts_sent, Bytes Received, Bytes"
53342,443,18889,443,allow,82909,70964,11945,139,283,71,68,1,"High deviation in pkts_sent, Bytes Sent, Bytes"
48817,49301,48817,49301,allow,490,149,341,2,1200,1,1,1,"High deviation in NAT Destination Port, Destination Port, Elapsed Time (sec)"
45374,443,48527,443,allow,88469,3492,84977,104,396,35,69,1,"High deviation in pkts_sent, Bytes Received, Bytes"
59297,80,59297,80,allow,107500,4003,103497,173,16,57,116,1,"High deviation in pkts_sent, Bytes Received, Bytes"
59298,80,59298,80,allow,85989,14398,71591,143,15,40,103,1,"High deviation in pkts_sent, Bytes Received, Bytes"
47894,443,29583,443,allow,295475,14093,281382,413,469,162,251,1,"High deviation in pkts_sent, Bytes Received, Bytes"
49518,443,49518,443,allow,103941,6635,97306,158,76,81,77,1,"High deviation in pkts_sent, Bytes Received, Bytes"
46248,443,47277,443,allow,979612,946319,33293,1091,25,690,401,1,"High deviation in pkts_sent, Bytes Sent, Bytes"
52209,443,18180,443,allow,502469,15202,487267,580,97,193,387,1,"High deviation in pkts_sent, Bytes Received, Bytes"
61673,443,61673,443,allow,76863,6096,70767,103,17,49,54,1,"High deviation in pkts_sent, Bytes Received, Bytes"
38701,443,23957,443,allow,1065134,19929,1045205,1009,16,288,721,1,"High deviation in pkts_sent, Bytes Received, Bytes"
49520,443,49520,443,allow,88797,5446,83351,137,76,70,67,1,"High deviation in pkts_sent, Bytes Received, Bytes"
48305,443,59833,443,allow,572565,17274,555291,546,147,124,422,1,"High deviation in pkts_sent, Bytes Received, Bytes"
63885,443,2549,443,allow,254829,10396,244433,255,194,64,191,1,"High deviation in pkts_sent, Bytes Received, Bytes"
52062,60388,61139,60388,allow,70,70,0,2,8,2,0,1,"High deviation in pkts_sent, NAT Destination Port, Destination Port"
51221,32329,23850,32329,allow,870,330,540,12,1316,6,6,1,"High deviation in pkts_sent, NAT Destination Port, Elapsed Time (sec)"
55877,42466,20270,42466,allow,481,150,331,2,1200,1,1,1,"High deviation in NAT Destination Port, Destination Port, Elapsed Time (sec)"
52165,443,19255,443,allow,289596,9131,280465,283,48,85,198,1,"High deviation in pkts_sent, Bytes Received, Bytes"
48833,443,62502,443,allow,1348406,28891,1319515,1247,31,340,907,1,"High deviation in pkts_sent, Bytes Received, Bytes"
52712,443,61572,443,allow,348281,20002,328279,401,350,153,248,1,"High deviation in pkts_sent, Bytes Received, Bytes"
63987,58476,60558,58476,allow,504,382,122,8,16,6,2,1,"High deviation in pkts_sent, NAT Destination Port, Destination Port"
48834,443,52235,443,allow,655052,13866,641186,599,31,150,449,1,"High deviation in pkts_sent, Bytes Received, Bytes"
48847,443,57026,443,allow,2478246,45190,2433056,2175,27,520,1655,1,"High deviation in pkts_sent, Bytes Received, Bytes"
57470,16288,57203,16288,allow,924,924,0,15,1200,15,0,1,"High deviation in pkts_sent, NAT Destination Port, Elapsed Time (sec)"
30960,45759,38428,45759,allow,330,330,0,6,3609,6,0,1,"High deviation in pkts_sent, NAT Destination Port, Elapsed Time (sec)"
50292,443,41099,443,allow,183024,16754,166270,247,28,114,133,1,"High deviation in pkts_sent, Bytes Received, Bytes"
55686,44049,11130,44049,allow,504,318,186,8,15,5,3,1,"High deviation in pkts_sent, NAT Destination Port, Destination Port"
65503,443,44158,443,allow,429890,12640,417250,442,16,155,287,1,"High deviation in pkts_sent, Bytes Received, Bytes"
53832,56005,63005,56005,allow,70,70,0,1,4,1,0,1,"High deviation in NAT Destination Port, Destination Port, NAT Source Port"
53185,443,52524,443,allow,4442408,142153,4300255,4731,235,1574,3157,1,"High deviation in pkts_sent, Bytes Received, Bytes"
65504,443,39358,443,allow,92275,4799,87476,107,16,43,64,1,"High deviation in pkts_sent, Bytes Received, Bytes"
63988,43365,3645,43365,allow,624,382,242,10,15,6,4,1,"High deviation in pkts_sent, NAT Destination Port, Destination Port"
50584,51414,36185,51414,allow,475,150,325,2,1200,1,1,1,"High deviation in NAT Destination Port, Destination Port, Elapsed Time (sec)"
30188,33285,47903,33285,allow,502,150,352,2,1200,1,1,1,"High deviation in NAT Destination Port, Destination Port, Elapsed Time (sec)"
61419,443,21446,443,allow,1664127,116770,1547357,2028,401,736,1292,1,"High deviation in pkts_sent, Bytes Received, Bytes"
44314,443,36123,443,allow,1268867,60489,1208378,1558,141,557,1001,1,"High deviation in pkts_sent, Bytes Received, Bytes"
51221,51413,55208,51413,allow,460,150,310,2,1201,1,1,1,"High deviation in NAT Destination Port, Destination Port, Elapsed Time (sec)"
53722,443,52101,443,allow,327838,13327,314511,355,127,121,234,1,"High deviation in pkts_sent, Bytes Received, Bytes"
10151,49001,62928,49001,allow,481,150,331,2,1201,1,1,1,"High deviation in NAT Destination Port, Destination Port, Elapsed Time (sec)"
37591,443,4877,443,allow,62657,4444,58213,83,46,37,46,1,"High deviation in pkts_sent, Bytes Received, Bytes"
49556,443,19377,443,allow,198375,6279,192096,205,153,69,136,1,"High deviation in pkts_sent, Bytes Received, Bytes"
49244,80,49244,80,allow,661753,15722,646031,683,17,235,448,1,"High deviation in pkts_sent, Bytes Received, Bytes"
10049,5222,44592,5222,allow,6103,3081,3022,63,616,34,29,1,"High deviation in pkts_sent, Bytes Sent, NAT Destination Port"
48625,443,33941,443,allow,29988,20891,9097,170,598,95,75,1,"High deviation in pkts_sent, Bytes Sent, Bytes"
58868,443,25875,443,allow,1826093,48237,1777856,1873,71,599,1274,1,"High deviation in pkts_sent, Bytes Received, Bytes"
60469,60092,64603,60092,allow,70,70,0,2,8,2,0,1,"High deviation in pkts_sent, NAT Destination Port, Destination Port"
6881,55981,51460,55981,allow,228,118,110,2,1200,1,1,1,"High deviation in NAT Destination Port, Destination Port, Elapsed Time (sec)"
60226,443,32684,443,allow,1907736,31488,1876248,1747,21,470,1277,1,"High deviation in pkts_sent, Bytes Received, Bytes"
45844,443,26065,443,allow,44232,11223,33009,97,460,50,47,1,"High deviation in pkts_sent, Bytes Sent, Bytes"
55262,443,33483,443,allow,28633618,753499,27880119,30116,102,8846,21270,1,"High deviation in pkts_sent, Bytes Received, Bytes"
46028,80,31228,80,allow,1176793,65077,1111716,1528,85,788,740,1,"High deviation in pkts_sent, Bytes Received, Bytes"
46029,80,61068,80,allow,111564,6775,104789,160,85,86,74,1,"High deviation in pkts_sent, Bytes Received, Bytes"
30960,45756,31120,45756,allow,396,396,0,7,3616,7,0,1,"High deviation in pkts_sent, NAT Destination Port, Elapsed Time (sec)"
19473,61397,60276,61397,allow,323,150,173,2,1200,1,1,1,"High deviation in NAT Destination Port, Destination Port, Elapsed Time (sec)"
51221,41939,7547,41939,allow,3917,1584,2333,50,3325,25,25,1,"High deviation in pkts_sent, NAT Destination Port, Elapsed Time (sec)"
53035,80,53035,80,allow,373926,8227,365699,379,143,130,249,1,"High deviation in pkts_sent, Bytes Received, Bytes"
63069,443,57757,443,allow,2523249,58976,2464273,2483,33,820,1663,1,"High deviation in pkts_sent, Bytes Received, Bytes"
53243,443,50839,443,allow,242426,7999,234427,277,70,100,177,1,"High deviation in pkts_sent, Bytes Received, Bytes"
63789,443,32462,443,allow,4407024,140001,4267023,4628,124,1546,3082,1,"High deviation in pkts_sent, Bytes Received, Bytes"
58849,443,61655,443,allow,36920,24591,12329,80,24,47,33,1,"High deviation in pkts_sent, Bytes Sent, Bytes"
49511,443,49511,443,allow,150713,27113,123600,199,82,104,95,1,"High deviation in pkts_sent, Bytes Received, Bytes"
50792,443,51398,443,allow,144115,19017,125098,229,400,112,117,1,"High deviation in pkts_sent, Bytes Received, Bytes"
63969,57635,11400,57635,allow,504,382,122,8,17,6,2,1,"High deviation in pkts_sent, NAT Destination Port, Destination Port"
53825,58968,36842,58968,allow,70,70,0,1,4,1,0,1,"High deviation in NAT Destination Port, Destination Port, NAT Source Port"
53239,443,57625,443,allow,84664,6099,78565,140,70,56,84,1,"High deviation in pkts_sent, Bytes Received, Bytes"
53254,443,6395,443,allow,310549,9420,301129,339,65,122,217,1,"High deviation in pkts_sent, Bytes Received, Bytes"
59911,80,3482,80,allow,2025658,45348,1980310,1992,44,640,1352,1,"High deviation in pkts_sent, Bytes Received, Bytes"
48844,443,50866,443,allow,36383,29447,6936,103,163,51,52,1,"High deviation in pkts_sent, Bytes Sent, Bytes"
53812,45694,7999,45694,allow,3156,1011,2145,16,16,8,8,1,"High deviation in pkts_sent, NAT Destination Port, Destination Port"
53136,443,65509,443,allow,3028365,2245986,782379,11999,627,7647,4352,1,"High deviation in pkts_sent, Bytes Sent, Bytes"
53458,443,17930,443,allow,144165,6110,138055,170,31,67,103,1,"High deviation in pkts_sent, Bytes Received, Bytes"
57470,41071,64833,41071,allow,1716,1716,0,27,1598,27,0,1,"High deviation in pkts_sent, NAT Destination Port, Elapsed Time (sec)"
64728,443,31234,443,allow,25423484,377367,25046117,21027,1082,2865,18162,1,"High deviation in pkts_sent, Bytes Received, Bytes"
30960,45754,34064,45754,allow,396,396,0,7,3615,7,0,1,"High deviation in pkts_sent, NAT Destination Port, Elapsed Time (sec)"
57338,443,31270,443,allow,222159,52803,169356,361,26,173,188,1,"High deviation in pkts_sent, Bytes Sent, Bytes"
50265,43178,20188,43178,allow,481,150,331,2,1200,1,1,1,"High deviation in NAT Destination Port, Destination Port, Elapsed Time (sec)"
60466,64337,52523,64337,allow,70,70,0,2,8,2,0,1,"High deviation in pkts_sent, NAT Destination Port, Destination Port"
36000,443,6421,443,allow,68705,5084,63621,93,172,36,57,1,"High deviation in pkts_sent, Bytes Received, Bytes"
36003,443,8954,443,allow,70007,4677,65330,92,172,36,56,1,"High deviation in pkts_sent, Bytes Received, Bytes"
53455,443,54035,443,allow,240325,8131,232194,262,31,100,162,1,"High deviation in pkts_sent, Bytes Received, Bytes"
52046,59791,37077,59791,allow,70,70,0,2,7,2,0,1,"High deviation in pkts_sent, NAT Destination Port, Destination Port"
58718,80,58718,80,allow,106571,3881,102690,128,16,56,72,1,"High deviation in pkts_sent, Bytes Received, Bytes"
49219,51237,3510,51237,allow,624,318,306,10,15,5,5,1,"High deviation in pkts_sent, NAT Destination Port, Destination Port"
56512,443,45161,443,allow,155750,151462,4288,169,215,112,57,1,"High deviation in pkts_sent, Bytes Sent, Bytes"
17750,60780,57502,60780,allow,481,150,331,2,1200,1,1,1,"High deviation in NAT Destination Port, Destination Port, Elapsed Time (sec)"
35989,443,62539,443,allow,2840032,64781,2775251,2709,292,769,1940,1,"High deviation in pkts_sent, Bytes Received, Bytes"
38699,443,63342,443,allow,759586,14873,744713,719,16,209,510,1,"High deviation in pkts_sent, Bytes Received, Bytes"
27005,52013,10619,52013,allow,901,126,775,2,31,1,1,1,"High deviation in NAT Destination Port, Destination Port, Bytes Received"
49217,52769,38751,52769,allow,2189,1143,1046,10,16,6,4,1,"High deviation in pkts_sent, NAT Destination Port, Destination Port"
40998,80,36819,80,allow,103213,8726,94487,178,38,109,69,1,"High deviation in pkts_sent, Bytes Received, Bytes"
56704,80,26438,80,allow,1146417,29701,1116716,1218,54,422,796,1,"High deviation in pkts_sent, Bytes Received, Bytes"
63978,63776,58166,63776,allow,70,70,0,1,4,1,0,1,"High deviation in NAT Destination Port, Destination Port, NAT Source Port"
53800,59950,39242,59950,allow,1973,1021,952,10,15,6,4,1,"High deviation in pkts_sent, NAT Destination Port, Destination Port"
49902,443,36938,443,allow,109400,8787,100613,159,81,78,81,1,"High deviation in pkts_sent, Bytes Received, Bytes"
65501,443,33887,443,allow,416348,12360,403988,429,16,151,278,1,"High deviation in pkts_sent, Bytes Received, Bytes"
65502,443,12498,443,allow,92573,4519,88054,105,16,39,66,1,"High deviation in pkts_sent, Bytes Received, Bytes"
60467,51095,40128,51095,allow,320,140,180,6,7,3,3,1,"High deviation in pkts_sent, NAT Destination Port, Destination Port"
52134,443,44449,443,allow,473832,22822,451010,464,109,139,325,1,"High deviation in pkts_sent, Bytes Received, Bytes"
37965,34591,32228,34591,allow,820,152,668,4,1199,2,2,1,"High deviation in pkts_sent, NAT Destination Port, Destination Port"
57470,51413,34007,51413,allow,460,150,310,2,1199,1,1,1,"High deviation in NAT Destination Port, Destination Port, Elapsed Time (sec)"
6882,25021,51756,25021,allow,509,150,359,2,1200,1,1,1,"High deviation in NAT Destination Port, Elapsed Time (sec), Destination Port"
47876,443,34439,443,allow,996037,37114,958923,1187,271,459,728,1,"High deviation in pkts_sent, Bytes Received, Bytes"
47668,443,3195,443,allow,69732,65832,3900,104,316,55,49,1,"High deviation in pkts_sent, Bytes Sent, Bytes"
30188,31063,61312,31063,allow,502,150,352,2,1200,1,1,1,"High deviation in NAT Destination Port, Elapsed Time (sec), Destination Port"
39192,80,42667,80,allow,62592,60966,1626,63,16,47,16,1,"High deviation in pkts_sent, Bytes Sent, Bytes"
53817,59216,40309,59216,allow,164,70,94,2,5,1,1,1,"High deviation in NAT Destination Port, Destination Port, NAT Source Port"
60456,58675,9788,58675,allow,1307,786,521,15,16,8,7,1,"High deviation in pkts_sent, NAT Destination Port, Destination Port"
53149,47383,18287,47383,allow,694,320,374,10,18,6,4,1,"High deviation in pkts_sent, NAT Destination Port, Destination Port"
52062,443,2872,443,allow,61141,52577,8564,102,363,50,52,1,"High deviation in pkts_sent, Bytes Sent, Bytes"
55647,443,60557,443,allow,90956,83597,7359,106,127,70,36,1,"High deviation in pkts_sent, Bytes Sent, Bytes"
56569,443,12304,443,allow,340595,9013,331582,345,80,119,226,1,"High deviation in pkts_sent, Bytes Received, Bytes"
56566,443,19189,443,allow,343737,9198,334539,348,80,121,227,1,"High deviation in pkts_sent, Bytes Received, Bytes"
60458,61473,34807,61473,allow,1587,935,652,14,16,8,6,1,"High deviation in pkts_sent, NAT Destination Port, Destination Port"
39607,443,22667,443,allow,559339,545011,14328,595,316,388,207,1,"High deviation in pkts_sent, Bytes Sent, Bytes"
49732,443,11249,443,allow,592433,191668,400765,1555,1157,608,947,1,"High deviation in pkts_sent, Bytes Sent, Bytes"
50265,40448,36258,40448,allow,2118,858,1260,28,1274,14,14,1,"High deviation in pkts_sent, NAT Destination Port, Destination Port"
60944,443,6650,443,allow,59999,8737,51262,95,18,43,52,1,"High deviation in pkts_sent, Bytes Received, Bytes"
60953,443,32015,443,allow,103580,4856,98724,133,17,56,77,1,"High deviation in pkts_sent, Bytes Received, Bytes"
60952,443,35261,443,allow,391561,17125,374436,478,17,213,265,1,"High deviation in pkts_sent, Bytes Received, Bytes"
57470,50321,52574,50321,allow,1584,1584,0,25,1537,25,0,1,"High deviation in pkts_sent, NAT Destination Port, Destination Port"
55877,56148,26245,56148,allow,481,150,331,2,1200,1,1,1,"High deviation in NAT Destination Port, Destination Port, Elapsed Time (sec)"
60455,65054,62710,65054,allow,624,318,306,10,16,5,5,1,"High deviation in pkts_sent, NAT Destination Port, Destination Port"
55078,80,14305,80,allow,265275,25834,239441,366,101,182,184,1,"High deviation in pkts_sent, Bytes Received, Bytes"
35955,5228,64424,5228,allow,6776,1542,5234,21,3600,12,9,1,"High deviation in pkts_sent, Elapsed Time (sec), NAT Destination Port"
15503,51413,47539,51413,allow,459,149,310,2,1200,1,1,1,"High deviation in NAT Destination Port, Destination Port, Elapsed Time (sec)"
59940,80,29186,80,allow,1169137,23501,1145636,1104,22,344,760,1,"High deviation in pkts_sent, Bytes Received, Bytes"
63961,51641,64148,51641,allow,504,382,122,8,16,6,2,1,"High deviation in pkts_sent, NAT Destination Port, Destination Port"
57470,58695,5572,58695,allow,726,726,0,12,1200,12,0,1,"High deviation in pkts_sent, NAT Destination Port, Destination Port"
57470,64738,24802,64738,allow,1577,594,983,20,1582,10,10,1,"High deviation in pkts_sent, NAT Destination Port, Destination Port"
34297,443,14287,443,allow,65853,31390,34463,203,694,105,98,1,"High deviation in pkts_sent, Bytes Sent, Bytes"
53798,62166,25360,62166,allow,164,70,94,2,4,1,1,1,"High deviation in NAT Destination Port, Destination Port, NAT Source Port"
49216,63752,26927,63752,allow,70,70,0,1,5,1,0,1,"High deviation in NAT Destination Port, Destination Port, NAT Source Port"
49196,443,53527,443,allow,789207,20847,768360,812,23,294,518,1,"High deviation in pkts_sent, Bytes Received, Bytes"
52016,80,9292,80,allow,124703,6134,118569,147,125,64,83,1,"High deviation in pkts_sent, Bytes Received, Bytes"
60341,443,14614,443,allow,54103,3190,50913,68,362,27,41,1,"High deviation in pkts_sent, Bytes Received, Bytes"
6881,38554,27434,38554,allow,221,111,110,2,1200,1,1,1,"High deviation in NAT Destination Port, Destination Port, Elapsed Time (sec)"
63997,59512,17767,59512,allow,312,132,180,6,5,3,3,1,"High deviation in pkts_sent, NAT Destination Port, Destination Port"
35047,53,53594,53,allow,70657,70002,655,845,88,839,6,1,"High deviation in pkts_sent, Bytes Sent, Packets"
49198,64509,55959,64509,allow,70,70,0,1,5,1,0,1,"High deviation in NAT Destination Port, Destination Port, NAT Source Port"
65379,443,37475,443,allow,76625,63648,12977,139,83,79,60,1,"High deviation in pkts_sent, Bytes Sent, Bytes"
42664,80,62788,80,allow,63654,7979,55675,90,91,49,41,1,"High deviation in pkts_sent, Bytes Received, Bytes"
49207,58751,38431,58751,allow,70,70,0,1,5,1,0,1,"High deviation in NAT Destination Port, Destination Port, NAT Source Port"
56607,443,26886,443,allow,133596,5859,127737,148,120,51,97,1,"High deviation in pkts_sent, Bytes Received, Bytes"
35047,53,40543,53,allow,214830,214584,246,2594,88,2591,3,1,"High deviation in pkts_sent, Bytes Sent, Packets"
49366,443,29757,443,allow,5777400,184445,5592955,6224,332,2268,3956,1,"High deviation in pkts_sent, Bytes Received, Bytes"
55245,443,43023,443,allow,7725129,126824,7598305,6259,607,740,5519,1,"High deviation in pkts_sent, Bytes Received, Bytes"
51221,51413,15223,51413,allow,460,150,310,2,1200,1,1,1,"High deviation in NAT Destination Port, Destination Port, Elapsed Time (sec)"
40326,443,22959,443,allow,7937,3883,4054,65,4602,25,40,1,"High deviation in pkts_sent, Elapsed Time (sec), Bytes Sent"
27005,49000,16886,49000,allow,887,126,761,2,31,1,1,1,"High deviation in NAT Destination Port, Destination Port, Bytes Received"
40472,443,17256,443,allow,317215,285998,31217,436,982,244,192,1,"High deviation in pkts_sent, Bytes Sent, Bytes"
52016,58318,42027,58318,allow,66,66,0,1,5,1,0,1,"High deviation in NAT Destination Port, Destination Port, NAT Source Port"
35437,443,7147,443,allow,53756,46525,7231,82,275,51,31,1,"High deviation in pkts_sent, Bytes Sent, Bytes"
53156,57780,14557,57780,allow,320,140,180,6,7,3,3,1,"High deviation in pkts_sent, NAT Destination Port, Destination Port"
19473,41049,5316,41049,allow,149,149,0,1,1200,1,0,1,"High deviation in NAT Destination Port, Destination Port, Elapsed Time (sec)"
49531,443,49531,443,allow,95223,30803,64420,107,23,50,57,1,"High deviation in pkts_sent, Bytes Sent, Bytes"
57033,443,35994,443,allow,1092898,42451,1050447,1213,155,423,790,1,"High deviation in pkts_sent, Bytes Received, Bytes"
51174,443,12417,443,allow,786014,23908,762106,803,47,276,527,1,"High deviation in pkts_sent, Bytes Received, Bytes"
49194,443,50497,443,allow,159850,5338,154512,179,200,64,115,1,"High deviation in pkts_sent, Bytes Received, Bytes"
38696,443,18796,443,allow,1069542,21337,1048205,1028,16,310,718,1,"High deviation in pkts_sent, Bytes Received, Bytes"
52093,443,48994,443,allow,3687037,41923,3645114,3002,34,534,2468,1,"High deviation in pkts_sent, Bytes Received, Bytes"
55690,54233,5574,54233,allow,320,140,180,6,6,3,3,1,"High deviation in pkts_sent, NAT Destination Port, Destination Port"
34341,28678,47024,28678,allow,1806,1806,0,22,224,22,0,1,"High deviation in pkts_sent, NAT Destination Port, Destination Port"
49369,443,63066,443,allow,6277395,184853,6092542,6543,317,2262,4281,1,"High deviation in pkts_sent, Bytes Received, Bytes"
63996,443,19057,443,allow,122293139,3727246,118565893,125460,331,39649,85811,1,"High deviation in pkts_sent, Bytes Received, Bytes"
49424,443,6642,443,allow,77408,4295,73113,106,271,52,54,1,"High deviation in pkts_sent, Bytes Received, Bytes"
43356,443,48473,443,allow,79561,11513,68048,183,94,95,88,1,"High deviation in pkts_sent, Bytes Received, Bytes"
53825,58968,28988,58968,allow,70,70,0,2,7,2,0,1,"High deviation in pkts_sent, NAT Destination Port, Destination Port"
55323,443,19578,443,allow,229587,8510,221077,245,121,82,163,1,"High deviation in pkts_sent, Bytes Received, Bytes"
49380,443,11402,443,allow,2382775,72482,2310293,2485,252,843,1642,1,"High deviation in pkts_sent, Bytes Received, Bytes"
49340,443,62697,443,allow,7492336,235716,7256620,8119,428,3022,5097,1,"High deviation in pkts_sent, Bytes Received, Bytes"
51195,443,30169,443,allow,291595,261981,29614,587,206,339,248,1,"High deviation in pkts_sent, Bytes Sent, Bytes"
33149,5228,22043,5228,allow,15651,3559,12092,63,6557,28,35,1,"High deviation in pkts_sent, Elapsed Time (sec), Bytes Received"
21133,24035,37028,24035,allow,481,150,331,2,1200,1,1,1,"High deviation in NAT Destination Port, Elapsed Time (sec), Destination Port"
49317,443,8477,443,allow,1486172,26246,1459926,1245,40,266,979,1,"High deviation in pkts_sent, Bytes Received, Bytes"
38961,443,19720,443,allow,67063,17409,49654,94,274,48,46,1,"High deviation in pkts_sent, Bytes Sent, Bytes"
38300,443,24962,443,allow,200383,4673,195710,196,30,58,138,1,"High deviation in pkts_sent, Bytes Received, Bytes"
62074,443,62074,443,allow,151233,12592,138641,190,19,88,102,1,"High deviation in pkts_sent, Bytes Received, Bytes"
49522,443,58242,443,allow,2731084,2639957,91127,2979,151,1945,1034,1,"High deviation in pkts_sent, Bytes Sent, Bytes"
39803,443,33160,443,allow,1701571,69958,1631613,1930,170,782,1148,1,"High deviation in pkts_sent, Bytes Received, Bytes"
50432,5222,28391,5222,allow,28281,9813,18468,196,608,100,96,1,"High deviation in pkts_sent, Bytes Sent, Bytes"
65499,443,30170,443,allow,410116,12150,397966,421,16,148,273,1,"High deviation in pkts_sent, Bytes Received, Bytes"
46082,443,8016,443,allow,137024,6442,130582,171,109,61,110,1,"High deviation in pkts_sent, Bytes Received, Bytes"
54449,443,31656,443,allow,128477,6347,122130,155,276,56,99,1,"High deviation in pkts_sent, Bytes Received, Bytes"
55821,443,39900,443,allow,128791,11254,117537,141,132,48,93,1,"High deviation in pkts_sent, Bytes Received, Bytes"
53425,51689,2819,51689,allow,546,306,240,9,142,5,4,1,"High deviation in pkts_sent, NAT Destination Port, Destination Port"
65500,443,21161,443,allow,91813,4379,87434,101,16,37,64,1,"High deviation in pkts_sent, Bytes Received, Bytes"
32927,443,31722,443,allow,867883,29498,838385,922,58,328,594,1,"High deviation in pkts_sent, Bytes Received, Bytes"
60452,62582,62916,62582,allow,70,70,0,1,5,1,0,1,"High deviation in NAT Destination Port, Destination Port, NAT Source Port"
44847,43154,42931,43154,allow,150,150,0,1,1200,1,0,1,"High deviation in NAT Destination Port, Destination Port, Elapsed Time (sec)"
15503,52798,43633,52798,allow,28448,16525,11923,253,3696,148,105,1,"High deviation in pkts_sent, NAT Destination Port, Bytes Sent"
30188,27772,64348,27772,allow,502,150,352,2,1200,1,1,1,"High deviation in NAT Destination Port, Elapsed Time (sec), Destination Port"
6882,50239,19851,50239,allow,296,150,146,2,1200,1,1,1,"High deviation in NAT Destination Port, Destination Port, Elapsed Time (sec)"
63978,63776,45573,63776,allow,66,66,0,2,8,2,0,1,"High deviation in pkts_sent, NAT Destination Port, Destination Port"
56715,443,19932,443,allow,1207531,28695,1178836,1184,46,400,784,1,"High deviation in pkts_sent, Bytes Received, Bytes"
54870,443,54870,443,allow,313399,38167,275232,411,23,205,206,1,"High deviation in pkts_sent, Bytes Received, Bytes"
51230,80,14122,80,allow,579418,15579,563839,599,76,219,380,1,"High deviation in pkts_sent, Bytes Received, Bytes"
54833,443,54833,443,allow,306802,26705,280097,395,21,190,205,1,"High deviation in pkts_sent, Bytes Received, Bytes"
50265,42805,33244,42805,allow,480,149,331,2,1200,1,1,1,"High deviation in NAT Destination Port, Destination Port, Elapsed Time (sec)"
54826,443,54826,443,allow,158092,23051,135041,216,21,110,106,1,"High deviation in pkts_sent, Bytes Received, Bytes"
49749,443,9817,443,allow,438048,86860,351188,491,420,213,278,1,"High deviation in pkts_sent, Bytes Received, Bytes"
49895,443,62049,443,allow,493316,12157,481159,470,94,122,348,1,"High deviation in pkts_sent, Bytes Received, Bytes"
55223,443,2473,443,allow,1118883,33814,1085069,1206,48,451,755,1,"High deviation in pkts_sent, Bytes Received, Bytes"
53770,58120,33681,58120,allow,684,432,252,10,19,6,4,1,"High deviation in pkts_sent, NAT Destination Port, Destination Port"
49503,443,38675,443,allow,1363701,35511,1328190,1382,271,476,906,1,"High deviation in pkts_sent, Bytes Received, Bytes"
33971,443,52032,443,allow,244193,7090,237103,260,136,87,173,1,"High deviation in pkts_sent, Bytes Received, Bytes"
59964,443,21876,443,allow,1346200,44765,1301435,1428,128,479,949,1,"High deviation in pkts_sent, Bytes Received, Bytes"
15503,61284,64885,61284,allow,16553,6930,9623,212,6269,106,106,1,"High deviation in pkts_sent, NAT Destination Port, Elapsed Time (sec)"
37965,31483,54456,31483,allow,4530,2856,1674,62,2421,35,27,1,"High deviation in pkts_sent, NAT Destination Port, Elapsed Time (sec)"
52148,443,33858,443,allow,375357,11451,363906,356,61,100,256,1,"High deviation in pkts_sent, Bytes Received, Bytes"
17750,51965,19962,51965,allow,150,150,0,1,1200,1,0,1,"High deviation in NAT Destination Port, Destination Port, Elapsed Time (sec)"
46479,443,13902,443,allow,5241,2026,3215,50,6660,18,32,1,"High deviation in pkts_sent, Elapsed Time (sec), Bytes Sent"
37965,46008,3180,46008,allow,132,132,0,3,1200,3,0,1,"High deviation in pkts_sent, NAT Destination Port, Destination Port"
56713,443,29098,443,allow,373053,9725,363328,374,45,129,245,1,"High deviation in pkts_sent, Bytes Received, Bytes"
52471,443,40608,443,allow,41966,23593,18373,89,154,42,47,1,"High deviation in pkts_sent, Bytes Sent, Bytes"
56711,443,22373,443,allow,1207531,28695,1178836,1184,45,400,784,1,"High deviation in pkts_sent, Bytes Received, Bytes"
54563,443,54563,443,allow,109880,24958,84922,154,20,83,71,1,"High deviation in pkts_sent, Bytes, Bytes Received"
56709,443,60934,443,allow,1239919,29325,1210594,1214,46,409,805,1,"High deviation in pkts_sent, Bytes Received, Bytes"
53817,59216,6687,59216,allow,258,70,188,4,8,2,2,1,"High deviation in pkts_sent, NAT Destination Port, Destination Port"
48996,443,35257,443,allow,128299,119001,9298,178,280,103,75,1,"High deviation in pkts_sent, Bytes Sent, Bytes"
64113,443,11350,443,allow,14057427,329652,13727775,13768,110,4655,9113,1,"High deviation in pkts_sent, Bytes Received, Bytes"
54439,443,63339,443,allow,44294,9390,34904,167,319,83,84,1,"High deviation in pkts_sent, Bytes Received, Bytes"
63901,42053,50757,42053,allow,2980,1647,1333,16,31,10,6,1,"High deviation in pkts_sent, NAT Destination Port, Destination Port"
53154,44645,45393,44645,allow,320,140,180,6,5,3,3,1,"High deviation in pkts_sent, NAT Destination Port, Destination Port"
54136,443,48147,443,allow,18716,8002,10714,100,945,51,49,1,"High deviation in pkts_sent, Bytes Sent, Bytes"
63951,55255,6079,55255,allow,1277,856,421,9,15,6,3,1,"High deviation in pkts_sent, NAT Destination Port, Destination Port"
8283,45858,25688,45858,allow,130,70,60,2,30,1,1,1,"High deviation in NAT Destination Port, Destination Port, Source Port"
53262,443,5546,443,allow,242149,7606,234543,260,150,92,168,1,"High deviation in pkts_sent, Bytes Received, Bytes"
63979,49547,9568,49547,allow,312,132,180,6,6,3,3,1,"High deviation in pkts_sent, NAT Destination Port, Destination Port"
57470,29137,36773,29137,allow,1386,1386,0,22,1610,22,0,1,"High deviation in pkts_sent, NAT Destination Port, Elapsed Time (sec)"
49160,52011,11430,52011,allow,800,150,650,4,1200,2,2,1,"High deviation in pkts_sent, NAT Destination Port, Destination Port"
63381,443,50807,443,allow,11344,5681,5663,34,3601,20,14,1,"High deviation in pkts_sent, Elapsed Time (sec), Bytes Sent"
37965,8272,8707,8272,allow,1577,594,983,20,1740,10,10,1,"High deviation in pkts_sent, NAT Destination Port, Elapsed Time (sec)"
57470,56098,25356,56098,allow,1359,726,633,6,1199,3,3,1,"High deviation in pkts_sent, NAT Destination Port, Destination Port"
58857,443,13362,443,allow,3439647,103607,3336040,3670,452,1291,2379,1,"High deviation in pkts_sent, Bytes Received, Bytes"
45897,443,62629,443,allow,2267946,70852,2197094,2429,316,859,1570,1,"High deviation in pkts_sent, Bytes Received, Bytes"
56953,443,23008,443,allow,66324,17448,48876,86,331,39,47,1,"High deviation in pkts_sent, Bytes Sent, Bytes"
61502,443,14539,443,allow,580643,7944,572699,475,41,86,389,1,"High deviation in pkts_sent, Bytes Received, Bytes"
57204,443,59109,443,allow,35981,14676,21305,63,320,31,32,1,"High deviation in pkts_sent, Bytes Sent, Bytes"
49582,80,30882,80,allow,454222,9730,444492,425,155,119,306,1,"High deviation in pkts_sent, Bytes Received, Bytes"
39914,443,20492,443,allow,26779179,169104,26610075,19911,91,1968,17943,1,"High deviation in pkts_sent, Bytes Received, Bytes"
61501,443,38275,443,allow,633920,7867,626053,505,41,81,424,1,"High deviation in pkts_sent, Bytes Received, Bytes"
60976,443,6084,443,allow,5027222,114898,4912324,4763,109,1375,3388,1,"High deviation in pkts_sent, Bytes Received, Bytes"
58858,443,56785,443,allow,7413235,214811,7198424,7869,344,2785,5084,1,"High deviation in pkts_sent, Bytes Received, Bytes"
58856,443,36240,443,allow,6350667,198580,6152087,6885,451,2497,4388,1,"High deviation in pkts_sent, Bytes Received, Bytes"
45896,443,32975,443,allow,1160457,45088,1115369,1320,315,518,802,1,"High deviation in pkts_sent, Bytes Received, Bytes"
49214,58485,53751,58485,allow,70,70,0,2,8,2,0,1,"High deviation in pkts_sent, NAT Destination Port, Destination Port"
50458,443,25872,443,allow,523577,34256,489321,1025,208,473,552,1,"High deviation in pkts_sent, Bytes Received, Bytes"
53798,62166,11396,62166,allow,258,70,188,4,7,2,2,1,"High deviation in pkts_sent, NAT Destination Port, Destination Port"
63954,60430,37652,60430,allow,70,70,0,1,4,1,0,1,"High deviation in NAT Destination Port, Destination Port, NAT Source Port"
48817,25636,48817,25636,allow,481,150,331,2,1200,1,1,1,"High deviation in NAT Destination Port, Elapsed Time (sec), Destination Port"
50465,80,51689,80,allow,3688274,86827,3601447,3622,32,1228,2394,1,"High deviation in pkts_sent, Bytes Received, Bytes"
49216,63752,46385,63752,allow,70,70,0,2,8,2,0,1,"High deviation in pkts_sent, NAT Destination Port, Destination Port"
38131,443,7949,443,allow,85590,4656,80934,111,37,47,64,1,"High deviation in pkts_sent, Bytes Received, Bytes"
52090,443,53299,443,allow,45583818,387905,45195913,35736,272,5246,30490,1,"High deviation in pkts_sent, Bytes Received, Bytes"
45898,443,17048,443,allow,814431,31637,782794,913,315,346,567,1,"High deviation in pkts_sent, Bytes Received, Bytes"
45900,443,8565,443,allow,1277649,37293,1240356,1337,303,459,878,1,"High deviation in pkts_sent, Bytes Received, Bytes"
6881,37321,46991,37321,allow,502,150,352,2,1199,1,1,1,"High deviation in NAT Destination Port, Destination Port, Elapsed Time (sec)"
37624,443,54201,443,allow,471102,14016,457086,503,25,191,312,1,"High deviation in pkts_sent, Bytes Received, Bytes"
57470,51413,19647,51413,allow,740725,699740,40985,1031,1411,616,415,1,"High deviation in pkts_sent, Bytes Sent, Bytes"
63964,60705,4477,60705,allow,312,132,180,6,7,3,3,1,"High deviation in pkts_sent, NAT Destination Port, Destination Port"
62231,443,62231,443,allow,180730,19869,160861,239,171,103,136,1,"High deviation in pkts_sent, Bytes Received, Bytes"
49158,443,3923,443,allow,23613,13099,10514,79,1341,36,43,1,"High deviation in pkts_sent, Bytes Sent, Bytes"
50076,80,29026,80,allow,26128,9214,16914,81,512,40,41,1,"High deviation in pkts_sent, Bytes Sent, Bytes"
50306,80,39882,80,allow,182517,10761,171756,265,352,130,135,1,"High deviation in pkts_sent, Bytes Received, Bytes"
46779,5228,25730,5228,allow,3775,2029,1746,30,3637,13,17,1,"High deviation in pkts_sent, Elapsed Time (sec), NAT Destination Port"
51968,443,14636,443,allow,122815,48545,74270,164,95,76,88,1,"High deviation in pkts_sent, Bytes Sent, Bytes"
50439,443,55602,443,allow,73712,18850,54862,135,717,61,74,1,"High deviation in pkts_sent, Bytes Sent, Bytes"
1737,80,1737,80,allow,424934,9929,415005,411,95,129,282,1,"High deviation in pkts_sent, Bytes Received, Bytes"
50562,443,53886,443,allow,103466,11111,92355,258,140,119,139,1,"High deviation in pkts_sent, Bytes Received, Bytes"
1736,80,1736,80,allow,101959,5508,96451,111,95,41,70,1,"High deviation in pkts_sent, Bytes Received, Bytes"
50311,443,2014,443,allow,133674,20935,112739,206,350,105,101,1,"High deviation in pkts_sent, Bytes Received, Bytes"
1735,80,1735,80,allow,78576,5218,73358,91,95,36,55,1,"High deviation in pkts_sent, Bytes Received, Bytes"
57593,28678,11489,28678,allow,1806,1806,0,22,225,22,0,1,"High deviation in pkts_sent, NAT Destination Port, Destination Port"
49198,64509,42217,64509,allow,70,70,0,2,8,2,0,1,"High deviation in pkts_sent, NAT Destination Port, Destination Port"
50526,80,52180,80,allow,259593,12828,246765,308,156,118,190,1,"High deviation in pkts_sent, Bytes Received, Bytes"
62226,443,62226,443,allow,130836,22940,107896,161,170,72,89,1,"High deviation in pkts_sent, Bytes Received, Bytes"
1738,80,1738,80,allow,87958,5378,82580,100,95,39,61,1,"High deviation in pkts_sent, Bytes Received, Bytes"
50525,80,36119,80,allow,152171,9332,142839,189,156,78,111,1,"High deviation in pkts_sent, Bytes Received, Bytes"
33643,443,12343,443,allow,163835,28514,135321,310,153,162,148,1,"High deviation in pkts_sent, Bytes Received, Bytes"
38695,443,12020,443,allow,1185199,19993,1165206,1088,16,289,799,1,"High deviation in pkts_sent, Bytes Received, Bytes"
50354,443,37764,443,allow,71226,18632,52594,137,318,63,74,1,"High deviation in pkts_sent, Bytes Sent, Bytes"
50463,80,10843,80,allow,287874,13215,274659,346,204,136,210,1,"High deviation in pkts_sent, Bytes Received, Bytes"
33836,443,3806,443,allow,18875,13913,4962,116,788,60,56,1,"High deviation in pkts_sent, Bytes Sent, Bytes"
54977,443,65082,443,allow,263411,11905,251506,318,144,118,200,1,"High deviation in pkts_sent, Bytes Received, Bytes"
1739,80,1739,80,allow,198357,5070,193287,197,95,63,134,1,"High deviation in pkts_sent, Bytes Received, Bytes"
1734,80,1734,80,allow,318813,10418,308395,314,95,102,212,1,"High deviation in pkts_sent, Bytes Received, Bytes"
50524,80,58944,80,allow,102242,12176,90066,149,156,68,81,1,"High deviation in pkts_sent, Bytes Received, Bytes"
50467,80,31924,80,allow,197269,14917,182352,254,204,107,147,1,"High deviation in pkts_sent, Bytes Received, Bytes"
50527,80,17326,80,allow,261781,16421,245360,330,156,137,193,1,"High deviation in pkts_sent, Bytes Received, Bytes"
62227,443,62227,443,allow,197342,62255,135087,232,170,110,122,1,"High deviation in pkts_sent, Bytes Sent, Bytes"
50462,80,37104,80,allow,113965,10014,103951,154,204,65,89,1,"High deviation in pkts_sent, Bytes Received, Bytes"
50222,443,25494,443,allow,178347,31093,147254,290,446,140,150,1,"High deviation in pkts_sent, Bytes Received, Bytes"
15503,51508,42580,51508,allow,481,150,331,2,1200,1,1,1,"High deviation in NAT Destination Port, Destination Port, Elapsed Time (sec)"
57470,12383,34199,12383,allow,5728,4818,910,87,4485,74,13,1,"High deviation in pkts_sent, Elapsed Time (sec), NAT Destination Port"
43130,443,2379,443,allow,207714,9731,197983,267,193,120,147,1,"High deviation in pkts_sent, Bytes Received, Bytes"
52152,443,39969,443,allow,433460,26631,406829,595,147,224,371,1,"High deviation in pkts_sent, Bytes Received, Bytes"
53801,47933,40487,47933,allow,320,140,180,6,6,3,3,1,"High deviation in pkts_sent, NAT Destination Port, Destination Port"
53802,59932,27956,59932,allow,320,140,180,6,6,3,3,1,"High deviation in pkts_sent, NAT Destination Port, Destination Port"
52016,58318,32216,58318,allow,70,70,0,2,9,2,0,1,"High deviation in pkts_sent, NAT Destination Port, Destination Port"
50265,31240,10906,31240,allow,726,726,0,12,1200,12,0,1,"High deviation in pkts_sent, NAT Destination Port, Elapsed Time (sec)"
55433,443,16673,443,allow,72759,18547,54212,120,137,49,71,1,"High deviation in pkts_sent, Bytes Sent, Bytes"
44847,31105,50353,31105,allow,324,150,174,2,1200,1,1,1,"High deviation in NAT Destination Port, Elapsed Time (sec), Destination Port"
51540,443,24638,443,allow,957715,36759,920956,1075,161,378,697,1,"High deviation in pkts_sent, Bytes Received, Bytes"
60858,443,17492,443,allow,64658,47775,16883,115,16,63,52,1,"High deviation in pkts_sent, Bytes Sent, Bytes"
49444,443,41469,443,allow,2293735,61874,2231861,2321,87,764,1557,1,"High deviation in pkts_sent, Bytes Received, Bytes"
49207,443,35081,443,allow,2643240,203689,2439551,3285,576,1237,2048,1,"High deviation in pkts_sent, Bytes Received, Bytes"
58432,443,22620,443,allow,26845,11746,15099,187,161,104,83,1,"High deviation in pkts_sent, Bytes Sent, Bytes"
56561,443,57452,443,allow,341343,9074,332269,353,121,122,231,1,"High deviation in pkts_sent, Bytes Received, Bytes"
50811,443,33324,443,allow,2719275,48822,2670453,2459,127,689,1770,1,"High deviation in pkts_sent, Bytes Received, Bytes"
56740,443,11618,443,allow,456259,379546,76713,1179,364,656,523,1,"High deviation in pkts_sent, Bytes Sent, Bytes"
49502,80,22198,80,allow,2300864,53111,2247753,2242,18,755,1487,1,"High deviation in pkts_sent, Bytes Received, Bytes"
55675,49271,26954,49271,allow,504,318,186,8,16,5,3,1,"High deviation in pkts_sent, NAT Destination Port, Destination Port"
49450,443,1753,443,allow,2319947,69322,2250625,2464,70,870,1594,1,"High deviation in pkts_sent, Bytes Received, Bytes"
45753,80,11896,80,allow,48495,10969,37526,83,477,39,44,1,"High deviation in pkts_sent, Bytes Received, Bytes"
50265,32988,60132,32988,allow,1488,930,558,21,1200,12,9,1,"High deviation in pkts_sent, NAT Destination Port, Destination Port"
56819,443,59951,443,allow,79878,10479,69399,138,120,68,70,1,"High deviation in pkts_sent, Bytes Received, Bytes"
49447,443,42024,443,allow,790501,27378,763123,858,86,322,536,1,"High deviation in pkts_sent, Bytes Received, Bytes"
45754,80,23823,80,allow,47137,10210,36927,80,477,38,42,1,"High deviation in pkts_sent, Bytes Received, Bytes"
52837,443,26069,443,allow,843201,50940,792261,1191,159,451,740,1,"High deviation in pkts_sent, Bytes Received, Bytes"
49451,443,37319,443,allow,1855625,57182,1798443,1981,70,703,1278,1,"High deviation in pkts_sent, Bytes Received, Bytes"
65497,443,27033,443,allow,392197,11800,380397,406,16,143,263,1,"High deviation in pkts_sent, Bytes Received, Bytes"
65498,443,2400,443,allow,92290,4799,87491,107,16,43,64,1,"High deviation in pkts_sent, Bytes Received, Bytes"
30188,23453,55935,23453,allow,502,150,352,2,1200,1,1,1,"High deviation in NAT Destination Port, Elapsed Time (sec), Destination Port"
37965,58609,35622,58609,allow,15544,7978,7566,132,3153,72,60,1,"High deviation in pkts_sent, NAT Destination Port, Bytes Sent"
25,55987,25,55987,allow,118,118,0,1,120,1,0,1,"High deviation in NAT Destination Port, Destination Port, Source Port"
10151,27715,29644,27715,allow,460,150,310,2,1200,1,1,1,"High deviation in NAT Destination Port, Elapsed Time (sec), Destination Port"
50584,20824,62214,20824,allow,324,150,174,2,1200,1,1,1,"High deviation in NAT Destination Port, Elapsed Time (sec), Destination Port"
53771,64351,48425,64351,allow,70,70,0,1,5,1,0,1,"High deviation in NAT Destination Port, Destination Port, NAT Source Port"
49204,54530,41547,54530,allow,316,136,180,6,6,3,3,1,"High deviation in pkts_sent, NAT Destination Port, Destination Port"
60475,443,52273,443,allow,585392,18731,566661,623,119,209,414,1,"High deviation in pkts_sent, Bytes Received, Bytes"
45755,80,26274,80,allow,52352,11192,41160,90,476,44,46,1,"High deviation in pkts_sent, Bytes Received, Bytes"
45756,80,2776,80,allow,41602,9508,32094,72,476,36,36,1,"High deviation in pkts_sent, Bytes, Bytes Received"
51912,45007,7239,45007,allow,1345,679,666,9,30,5,4,1,"High deviation in pkts_sent, NAT Destination Port, Destination Port"
51260,80,52216,80,allow,23175,13071,10104,134,1929,67,67,1,"High deviation in pkts_sent, Bytes Sent, Bytes"
53777,62955,56420,62955,allow,70,70,0,1,4,1,0,1,"High deviation in NAT Destination Port, Destination Port, NAT Source Port"
49261,80,5363,80,allow,3802643,113349,3689294,3463,206,982,2481,1,"High deviation in pkts_sent, Bytes Received, Bytes"
55673,54815,52506,54815,allow,316,190,126,5,15,3,2,1,"High deviation in pkts_sent, NAT Destination Port, Destination Port"
64567,443,55637,443,allow,272081,11032,261049,304,139,107,197,1,"High deviation in pkts_sent, Bytes Received, Bytes"
60452,62582,61377,62582,allow,70,70,0,2,8,2,0,1,"High deviation in pkts_sent, NAT Destination Port, Destination Port"
49296,443,49940,443,allow,20862040,250452,20611588,16880,170,1832,15048,1,"High deviation in pkts_sent, Bytes Received, Bytes"
55739,443,29426,443,allow,10875114,348643,10526471,11702,194,3853,7849,1,"High deviation in pkts_sent, Bytes Received, Bytes"
19473,53813,59984,53813,allow,481,150,331,2,1200,1,1,1,"High deviation in NAT Destination Port, Destination Port, Elapsed Time (sec)"
57470,43323,55435,43323,allow,2292,332,1960,11,1200,5,6,1,"High deviation in pkts_sent, NAT Destination Port, Destination Port"
9122,80,61976,80,allow,98161,5033,93128,125,37,45,80,1,"High deviation in pkts_sent, Bytes Received, Bytes"
61408,80,60964,80,allow,420720,29056,391664,771,159,325,446,1,"High deviation in pkts_sent, Bytes Received, Bytes"
33965,443,25810,443,allow,1409634,52704,1356930,1536,173,533,1003,1,"High deviation in pkts_sent, Bytes Received, Bytes"
50510,443,23339,443,allow,2259313,91208,2168105,2847,1409,1118,1729,1,"High deviation in pkts_sent, Bytes Received, Bytes"
49513,443,49513,443,allow,140969,40311,100658,180,68,92,88,1,"High deviation in pkts_sent, Bytes Sent, Bytes"
46081,443,10510,443,allow,125213,5113,120100,153,96,58,95,1,"High deviation in pkts_sent, Bytes Received, Bytes"
55022,60100,63915,60100,allow,1550,1130,420,15,25,9,6,1,"High deviation in pkts_sent, NAT Destination Port, Destination Port"
52012,63475,43517,63475,allow,316,136,180,6,7,3,3,1,"High deviation in pkts_sent, NAT Destination Port, Destination Port"
49826,443,3257,443,allow,102548,19098,83450,140,35,60,80,1,"High deviation in pkts_sent, Bytes Received, Bytes"
53751,443,64587,443,allow,61501,14276,47225,91,35,39,52,1,"High deviation in pkts_sent, Bytes, Bytes Received"
9187,443,51654,443,allow,158704,5074,153630,184,34,69,115,1,"High deviation in pkts_sent, Bytes Received, Bytes"
6881,43642,35387,43642,allow,150,150,0,1,1201,1,0,1,"High deviation in NAT Destination Port, Destination Port, Elapsed Time (sec)"
62417,443,4381,443,allow,79513,7480,72033,106,122,39,67,1,"High deviation in pkts_sent, Bytes Received, Bytes"
54678,443,37690,443,allow,84066,79714,4352,98,125,66,32,1,"High deviation in pkts_sent, Bytes Sent, Bytes"
30960,45746,57659,45746,allow,330,330,0,6,3609,6,0,1,"High deviation in pkts_sent, NAT Destination Port, Elapsed Time (sec)"
21133,51413,31456,51413,allow,459,149,310,2,1200,1,1,1,"High deviation in NAT Destination Port, Destination Port, Elapsed Time (sec)"
57983,443,8445,443,allow,315701,12378,303323,358,137,129,229,1,"High deviation in pkts_sent, Bytes Received, Bytes"
61409,80,63776,80,allow,201243,14555,186688,357,158,145,212,1,"High deviation in pkts_sent, Bytes Received, Bytes"
9120,80,19755,80,allow,326320,11951,314369,346,36,122,224,1,"High deviation in pkts_sent, Bytes Received, Bytes"
51978,57496,57419,57496,allow,70,70,0,1,5,1,0,1,"High deviation in NAT Destination Port, Destination Port, NAT Source Port"
56429,443,13104,443,allow,227145,7409,219736,252,146,86,166,1,"High deviation in pkts_sent, Bytes Received, Bytes"
61411,80,31645,80,allow,145440,11034,134406,292,158,135,157,1,"High deviation in pkts_sent, Bytes Received, Bytes"
61413,80,4426,80,allow,283970,23419,260551,574,158,255,319,1,"High deviation in pkts_sent, Bytes Received, Bytes"
61410,80,27494,80,allow,297783,19995,277788,543,158,229,314,1,"High deviation in pkts_sent, Bytes Received, Bytes"
9140,80,58869,80,allow,49165,1785,47380,56,36,21,35,1,"High deviation in pkts_sent, Bytes Received, Bytes"
50560,443,29461,443,allow,408090,25873,382217,748,137,354,394,1,"High deviation in pkts_sent, Bytes Received, Bytes"
57470,64430,53438,64430,allow,1386,1386,0,22,1526,22,0,1,"High deviation in pkts_sent, NAT Destination Port, Destination Port"
47758,443,3505,443,allow,299614,32024,267590,587,115,304,283,1,"High deviation in pkts_sent, Bytes Received, Bytes"
30188,63236,11932,63236,allow,11247,4773,6474,66,1454,32,34,1,"High deviation in pkts_sent, NAT Destination Port, Bytes Sent"
52396,443,30033,443,allow,1253628,61672,1191956,1875,220,939,936,1,"High deviation in pkts_sent, Bytes Received, Bytes"
54270,443,64669,443,allow,29945,19086,10859,98,736,50,48,1,"High deviation in pkts_sent, Bytes Sent, Bytes"
61295,443,30551,443,allow,134322,10347,123975,220,304,77,143,1,"High deviation in pkts_sent, Bytes Received, Bytes"
38774,80,38774,80,allow,369073,4523,364550,316,142,59,257,1,"High deviation in pkts_sent, Bytes Received, Bytes"
50943,443,64250,443,allow,29452,1988,27464,37,3619,10,27,1,"High deviation in pkts_sent, Bytes Received, Bytes"
6881,35156,27681,35156,allow,509,150,359,2,1199,1,1,1,"High deviation in NAT Destination Port, Destination Port, Elapsed Time (sec)"
57470,31114,57905,31114,allow,528,528,0,9,1199,9,0,1,"High deviation in pkts_sent, NAT Destination Port, Elapsed Time (sec)"
55490,80,37170,80,allow,186387,10616,175771,243,33,116,127,1,"High deviation in pkts_sent, Bytes Received, Bytes"
53763,50144,49298,50144,allow,492,306,186,8,16,5,3,1,"High deviation in pkts_sent, NAT Destination Port, Destination Port"
44384,80,20153,80,allow,51651,48866,2785,74,19,38,36,1,"High deviation in pkts_sent, Bytes Sent, Bytes"
64751,443,49226,443,allow,507753,8795,498958,463,195,122,341,1,"High deviation in pkts_sent, Bytes Received, Bytes"
14829,443,14829,443,allow,214215,11945,202270,260,94,110,150,1,"High deviation in pkts_sent, Bytes Received, Bytes"
42955,80,63046,80,allow,72023,4897,67126,97,115,46,51,1,"High deviation in pkts_sent, Bytes Received, Bytes"
57470,50321,35732,50321,allow,490,149,341,2,1201,1,1,1,"High deviation in NAT Destination Port, Destination Port, Elapsed Time (sec)"
53855,443,61273,443,allow,134631,7253,127378,176,171,79,97,1,"High deviation in pkts_sent, Bytes Received, Bytes"
49514,443,49514,443,allow,234110,36300,197810,309,66,160,149,1,"High deviation in pkts_sent, Bytes Received, Bytes"
55494,80,14370,80,allow,188544,9826,178718,241,32,113,128,1,"High deviation in pkts_sent, Bytes Received, Bytes"
17750,55265,61135,55265,allow,481,150,331,2,1200,1,1,1,"High deviation in NAT Destination Port, Destination Port, Elapsed Time (sec)"
53761,54363,63571,54363,allow,618,432,186,9,16,6,3,1,"High deviation in pkts_sent, NAT Destination Port, Destination Port"
53848,443,21534,443,allow,7015200,135026,6880174,6063,438,1252,4811,1,"High deviation in pkts_sent, Bytes Received, Bytes"
49194,443,5495,443,allow,605037,246018,359019,1735,1300,846,889,1,"High deviation in pkts_sent, Bytes Sent, Bytes"
50265,38978,6940,38978,allow,481,150,331,2,1200,1,1,1,"High deviation in NAT Destination Port, Destination Port, Elapsed Time (sec)"
49509,443,49509,443,allow,242669,43830,198839,310,67,159,151,1,"High deviation in pkts_sent, Bytes Received, Bytes"
63931,443,46072,443,allow,103248,6121,97127,124,144,47,77,1,"High deviation in pkts_sent, Bytes Received, Bytes"
50326,443,38402,443,allow,552885,34781,518104,733,245,314,419,1,"High deviation in pkts_sent, Bytes Received, Bytes"
55492,80,58922,80,allow,164902,9835,155067,227,32,114,113,1,"High deviation in pkts_sent, Bytes Received, Bytes"
54080,443,47688,443,allow,1173681,52597,1121084,1428,177,642,786,1,"High deviation in pkts_sent, Bytes Received, Bytes"
54079,443,33342,443,allow,1050267,44816,1005451,1276,177,580,696,1,"High deviation in pkts_sent, Bytes Received, Bytes"
53853,443,32341,443,allow,1966450,57437,1909013,1885,338,544,1341,1,"High deviation in pkts_sent, Bytes Received, Bytes"
6881,55980,18375,55980,allow,226,118,108,2,1199,1,1,1,"High deviation in NAT Destination Port, Destination Port, Elapsed Time (sec)"
55489,80,62350,80,allow,180504,12712,167792,229,32,105,124,1,"High deviation in pkts_sent, Bytes Received, Bytes"
63954,60430,18529,60430,allow,66,66,0,2,8,2,0,1,"High deviation in pkts_sent, NAT Destination Port, Destination Port"
34662,443,60147,443,allow,50100,46087,4013,73,121,43,30,1,"High deviation in pkts_sent, Bytes Sent, Bytes"
58045,80,55044,80,allow,62067,24127,37940,79,34,33,46,1,"High deviation in pkts_sent, Bytes Sent, Bytes"
52016,443,52016,443,allow,219803,9390,210413,222,49,72,150,1,"High deviation in pkts_sent, Bytes Received, Bytes"
2226,443,2226,443,allow,46743,4890,41853,69,23,35,34,1,"High deviation in pkts_sent, Bytes Received, Bytes"
2506,443,2506,443,allow,35555,4646,30909,59,23,33,26,1,"High deviation in pkts_sent, Bytes Received, Bytes"
58386,443,54159,443,allow,17470103,920642,16549461,18410,181,6438,11972,1,"High deviation in pkts_sent, Bytes Received, Bytes"
46554,5228,16651,5228,allow,4520,2520,2000,40,3961,20,20,1,"High deviation in pkts_sent, Elapsed Time (sec), Bytes Sent"
49344,443,51198,443,allow,272627,89686,182941,461,149,220,241,1,"High deviation in pkts_sent, Bytes Sent, Bytes"
49365,443,7020,443,allow,442336,371266,71070,1143,762,651,492,1,"High deviation in pkts_sent, Bytes Sent, Bytes"
55493,80,50792,80,allow,133558,8265,125293,186,31,93,93,1,"High deviation in pkts_sent, Bytes Received, Bytes"
54069,443,6998,443,allow,887350,41179,846171,1082,210,487,595,1,"High deviation in pkts_sent, Bytes Received, Bytes"
38692,443,1550,443,allow,1188751,17817,1170934,1053,16,255,798,1,"High deviation in pkts_sent, Bytes Received, Bytes"
44732,80,44732,80,allow,369759,9557,360202,388,22,137,251,1,"High deviation in pkts_sent, Bytes Received, Bytes"
52009,443,52009,443,allow,588633,17490,571143,578,51,186,392,1,"High deviation in pkts_sent, Bytes Received, Bytes"
52011,443,52011,443,allow,110812,7779,103033,122,49,44,78,1,"High deviation in pkts_sent, Bytes Received, Bytes"
54078,443,47563,443,allow,1060654,45683,1014971,1265,176,560,705,1,"High deviation in pkts_sent, Bytes Received, Bytes"
49194,65100,3468,65100,allow,624,318,306,10,15,5,5,1,"High deviation in pkts_sent, NAT Destination Port, Destination Port"
55491,80,9905,80,allow,204936,10932,194004,277,31,140,137,1,"High deviation in pkts_sent, Bytes Received, Bytes"
60899,443,59717,443,allow,847673,42767,804906,1045,89,441,604,1,"High deviation in pkts_sent, Bytes Received, Bytes"
54081,443,47129,443,allow,444890,27602,417288,580,176,265,315,1,"High deviation in pkts_sent, Bytes Received, Bytes"
54070,443,51450,443,allow,828875,45659,783216,1020,210,456,564,1,"High deviation in pkts_sent, Bytes Received, Bytes"
60966,443,26414,443,allow,60331,12765,47566,119,105,57,62,1,"High deviation in pkts_sent, Bytes Received, Bytes"
37965,35771,32766,35771,allow,481,150,331,2,1199,1,1,1,"High deviation in NAT Destination Port, Destination Port, Elapsed Time (sec)"
38469,80,38469,80,allow,555104,4582,550522,446,20,60,386,1,"High deviation in pkts_sent, Bytes Received, Bytes"
57987,3478,61463,3478,allow,60483,25857,34626,136,47,63,73,1,"High deviation in pkts_sent, Bytes Sent, Bytes"
49307,443,35042,443,allow,245382,6838,238544,214,31,44,170,1,"High deviation in pkts_sent, Bytes Received, Bytes"
57470,43611,57055,43611,allow,3960,3960,0,61,3411,61,0,1,"High deviation in pkts_sent, NAT Destination Port, Elapsed Time (sec)"
55034,443,55034,443,allow,154907,10748,144159,217,20,101,116,1,"High deviation in pkts_sent, Bytes Received, Bytes"
55336,443,52055,443,allow,209596,37190,172406,378,79,184,194,1,"High deviation in pkts_sent, Bytes Received, Bytes"
6882,16276,42707,16276,allow,150,150,0,1,1200,1,0,1,"High deviation in NAT Destination Port, Elapsed Time (sec), Destination Port"
30960,45744,39744,45744,allow,330,330,0,6,3609,6,0,1,"High deviation in pkts_sent, NAT Destination Port, Elapsed Time (sec)"
65495,443,43238,443,allow,418463,12360,406103,430,16,151,279,1,"High deviation in pkts_sent, Bytes Received, Bytes"
54148,443,30287,443,allow,272587,11910,260677,336,76,140,196,1,"High deviation in pkts_sent, Bytes Received, Bytes"
60903,443,18682,443,allow,333062,18123,314939,420,88,182,238,1,"High deviation in pkts_sent, Bytes Received, Bytes"
51170,443,40281,443,allow,9894856,232425,9662431,9829,90,3300,6529,1,"High deviation in pkts_sent, Bytes Received, Bytes"
36668,443,55888,443,allow,142299,120615,21684,348,336,180,168,1,"High deviation in pkts_sent, Bytes Sent, Bytes"
54336,443,1774,443,allow,172701,6397,166304,202,246,72,130,1,"High deviation in pkts_sent, Bytes Received, Bytes"
54924,443,20791,443,allow,53816,22991,30825,139,306,71,68,1,"High deviation in pkts_sent, Bytes Sent, Bytes"
48817,51413,48817,51413,allow,460,150,310,2,1200,1,1,1,"High deviation in NAT Destination Port, Destination Port, Elapsed Time (sec)"
54150,443,60800,443,allow,230997,10675,220322,291,75,122,169,1,"High deviation in pkts_sent, Bytes Received, Bytes"
37965,33149,27231,33149,allow,3957,2324,1633,51,1732,29,22,1,"High deviation in pkts_sent, NAT Destination Port, Elapsed Time (sec)"
30188,55886,45541,55886,allow,502,150,352,2,1200,1,1,1,"High deviation in NAT Destination Port, Destination Port, Elapsed Time (sec)"
49512,443,49512,443,allow,217225,47956,169269,284,64,149,135,1,"High deviation in pkts_sent, Bytes Received, Bytes"
65496,443,16540,443,allow,92799,4939,87860,111,16,45,66,1,"High deviation in pkts_sent, Bytes Received, Bytes"
44847,23628,55980,23628,allow,509,150,359,2,1200,1,1,1,"High deviation in NAT Destination Port, Elapsed Time (sec), Destination Port"
62338,443,61578,443,allow,13396186,148566,13247620,10474,59,1498,8976,1,"High deviation in pkts_sent, Bytes Received, Bytes"
57985,443,21475,443,allow,140109,5229,134880,159,46,59,100,1,"High deviation in pkts_sent, Bytes Received, Bytes"
55686,443,35273,443,allow,319563,13365,306198,344,123,119,225,1,"High deviation in pkts_sent, Bytes Received, Bytes"
53758,63975,2179,63975,allow,2016,1076,940,14,17,8,6,1,"High deviation in pkts_sent, NAT Destination Port, Destination Port"
54886,443,54886,443,allow,136775,6729,130046,181,18,82,99,1,"High deviation in pkts_sent, Bytes Received, Bytes"
47111,80,20951,80,allow,162355,7124,155231,207,27,96,111,1,"High deviation in pkts_sent, Bytes Received, Bytes"
53144,58987,40200,58987,allow,70,70,0,1,5,1,0,1,"High deviation in NAT Destination Port, Destination Port, NAT Source Port"
54644,443,54644,443,allow,103968,5475,98493,141,18,63,78,1,"High deviation in pkts_sent, Bytes Received, Bytes"
54470,443,54470,443,allow,101021,6173,94848,142,18,65,77,1,"High deviation in pkts_sent, Bytes Received, Bytes"
55230,443,46201,443,allow,42376115,1180708,41195407,45399,148,13976,31423,1,"High deviation in pkts_sent, Bytes Received, Bytes"
54952,443,11665,443,allow,61842,4466,57376,109,293,46,63,1,"High deviation in pkts_sent, Bytes Received, Bytes"
55660,42459,61425,42459,allow,1717,1129,588,17,25,10,7,1,"High deviation in pkts_sent, NAT Destination Port, Destination Port"
40151,5228,21276,5228,allow,19172,3089,16083,43,3601,20,23,1,"High deviation in pkts_sent, Elapsed Time (sec), Bytes Received"
49262,80,49262,80,allow,515211,10976,504235,506,49,169,337,1,"High deviation in pkts_sent, Bytes Received, Bytes"
63932,63241,5696,63241,allow,436,254,182,7,15,4,3,1,"High deviation in pkts_sent, NAT Destination Port, Destination Port"
53142,47933,51357,47933,allow,698,320,378,10,17,6,4,1,"High deviation in pkts_sent, NAT Destination Port, Destination Port"
59823,443,6570,443,allow,27406,15466,11940,123,188,62,61,1,"High deviation in pkts_sent, Bytes Sent, Bytes"
37739,443,17741,443,allow,138037,13843,124194,197,206,94,103,1,"High deviation in pkts_sent, Bytes Received, Bytes"
15503,19168,41378,19168,allow,481,150,331,2,1200,1,1,1,"High deviation in NAT Destination Port, Elapsed Time (sec), Destination Port"
37736,443,40675,443,allow,498507,26210,472297,544,207,200,344,1,"High deviation in pkts_sent, Bytes Received, Bytes"
39426,443,8694,443,allow,903603,21528,882075,858,57,234,624,1,"High deviation in pkts_sent, Bytes Received, Bytes"
51985,80,53937,80,allow,14233438,253696,13979742,12752,54,3515,9237,1,"High deviation in pkts_sent, Bytes Received, Bytes"
37738,443,40273,443,allow,296068,21814,274254,358,206,150,208,1,"High deviation in pkts_sent, Bytes Received, Bytes"
51993,55279,27826,55279,allow,316,136,180,6,7,3,3,1,"High deviation in pkts_sent, NAT Destination Port, Destination Port"
49396,80,45610,80,allow,13738839,196158,13542681,11272,248,2231,9041,1,"High deviation in pkts_sent, Bytes Received, Bytes"
63928,61494,31292,61494,allow,1691,446,1245,10,15,7,3,1,"High deviation in pkts_sent, NAT Destination Port, Destination Port"
37737,443,61948,443,allow,190013,14784,175229,238,206,101,137,1,"High deviation in pkts_sent, Bytes Received, Bytes"
53756,61137,24650,61137,allow,672,306,366,11,16,5,6,1,"High deviation in pkts_sent, NAT Destination Port, Destination Port"
53771,64351,44787,64351,allow,70,70,0,2,8,2,0,1,"High deviation in pkts_sent, NAT Destination Port, Destination Port"
59283,80,59283,80,allow,72354,14398,57956,123,15,40,83,1,"High deviation in pkts_sent, Bytes Received, Bytes"
6881,30279,63096,30279,allow,150,150,0,1,1200,1,0,1,"High deviation in NAT Destination Port, Elapsed Time (sec), Destination Port"
59282,80,59282,80,allow,181627,17128,164499,277,15,79,198,1,"High deviation in pkts_sent, Bytes Received, Bytes"
59281,80,59281,80,allow,108922,4633,104289,194,16,66,128,1,"High deviation in pkts_sent, Bytes Received, Bytes"
51991,56980,61136,56980,allow,316,136,180,6,7,3,3,1,"High deviation in pkts_sent, NAT Destination Port, Destination Port"
54325,7000,54325,7000,allow,755529,16895,738634,785,16,264,521,1,"High deviation in pkts_sent, Bytes Received, Bytes"
59279,80,59279,80,allow,108786,4563,104223,192,16,65,127,1,"High deviation in pkts_sent, Bytes Received, Bytes"
51221,51413,63036,51413,allow,459,149,310,2,1200,1,1,1,"High deviation in NAT Destination Port, Destination Port, Elapsed Time (sec)"
10151,34592,23117,34592,allow,480,149,331,2,1200,1,1,1,"High deviation in NAT Destination Port, Destination Port, Elapsed Time (sec)"
60435,443,42755,443,allow,38888447,473172,38415275,31568,128,5708,25860,1,"High deviation in pkts_sent, Bytes Received, Bytes"
57470,62314,37389,62314,allow,1188,1188,0,19,2338,19,0,1,"High deviation in pkts_sent, NAT Destination Port, Destination Port"
53777,62955,35330,62955,allow,70,70,0,2,7,2,0,1,"High deviation in pkts_sent, NAT Destination Port, Destination Port"
63907,54218,37939,54218,allow,696,452,244,11,21,7,4,1,"High deviation in pkts_sent, NAT Destination Port, Destination Port"
48745,443,43215,443,allow,229628,10653,218975,263,49,103,160,1,"High deviation in pkts_sent, Bytes Received, Bytes"
36498,80,36498,80,allow,161054,3432,157622,140,158,24,116,1,"High deviation in pkts_sent, Bytes Received, Bytes"
51951,65387,33774,65387,allow,70,70,0,1,5,1,0,1,"High deviation in NAT Destination Port, Destination Port, NAT Source Port"
53753,46790,44362,46790,allow,492,306,186,8,15,5,3,1,"High deviation in pkts_sent, NAT Destination Port, Destination Port"
39774,443,8618,443,allow,69542,11991,57551,139,157,60,79,1,"High deviation in pkts_sent, Bytes Received, Bytes"
63823,51558,31200,51558,allow,1518,1396,122,12,45,10,2,1,"High deviation in pkts_sent, NAT Destination Port, Destination Port"
37965,61282,39357,61282,allow,402,132,270,6,1208,3,3,1,"High deviation in pkts_sent, NAT Destination Port, Destination Port"
39004,443,10788,443,allow,38459,27564,10895,97,189,49,48,1,"High deviation in pkts_sent, Bytes Sent, Bytes"
49190,443,44351,443,allow,568536,16389,552147,598,19,224,374,1,"High deviation in pkts_sent, Bytes Received, Bytes"
33044,443,19147,443,allow,268582,23654,244928,341,190,128,213,1,"High deviation in pkts_sent, Bytes Received, Bytes"
50468,443,35607,443,allow,227265,6450,220815,225,124,63,162,1,"High deviation in pkts_sent, Bytes Received, Bytes"
64475,443,53340,443,allow,251092,8989,242103,282,123,98,184,1,"High deviation in pkts_sent, Bytes Received, Bytes"
53774,58433,12540,58433,allow,320,140,180,6,7,3,3,1,"High deviation in pkts_sent, NAT Destination Port, Destination Port"
57106,443,27171,443,allow,38893,31305,7588,107,101,55,52,1,"High deviation in pkts_sent, Bytes Sent, Bytes"
49515,443,49515,443,allow,102168,31819,70349,140,62,75,65,1,"High deviation in pkts_sent, Bytes Sent, Bytes"
42920,443,33787,443,allow,883886,26396,857490,947,444,340,607,1,"High deviation in pkts_sent, Bytes Received, Bytes"
19473,20467,44164,20467,allow,480,149,331,2,1200,1,1,1,"High deviation in NAT Destination Port, Elapsed Time (sec), Destination Port"
45987,443,65054,443,allow,3160640,65300,3095340,2786,144,547,2239,1,"High deviation in pkts_sent, Bytes Received, Bytes"
30960,45721,23609,45721,allow,66,66,0,1,3600,1,0,1,"High deviation in NAT Destination Port, Elapsed Time (sec), Destination Port"
55665,44235,23820,44235,allow,504,318,186,8,15,5,3,1,"High deviation in pkts_sent, NAT Destination Port, Destination Port"
50920,443,1716,443,allow,24070,16123,7947,82,6308,42,40,1,"High deviation in pkts_sent, Bytes Sent, Elapsed Time (sec)"
38832,443,4622,443,allow,23292,17154,6138,141,522,79,62,1,"High deviation in pkts_sent, Bytes Sent, Bytes"
62337,443,30628,443,allow,3908576,93181,3815395,3743,56,1160,2583,1,"High deviation in pkts_sent, Bytes Received, Bytes"
60130,443,10266,443,allow,16291,9102,7189,94,508,42,52,1,"High deviation in pkts_sent, Bytes Sent, Bytes"
48738,443,11931,443,allow,131514,7190,124324,183,53,72,111,1,"High deviation in pkts_sent, Bytes Received, Bytes"
56789,443,21644,443,allow,257154,11550,245604,303,54,121,182,1,"High deviation in pkts_sent, Bytes Received, Bytes"
51978,57496,25018,57496,allow,70,70,0,2,8,2,0,1,"High deviation in pkts_sent, NAT Destination Port, Destination Port"
52647,443,40426,443,allow,46502,33690,12812,93,234,55,38,1,"High deviation in pkts_sent, Bytes Sent, Bytes"
55603,32520,10079,32520,allow,5982,1890,4092,30,75,15,15,1,"High deviation in pkts_sent, NAT Destination Port, Destination Port"
54977,443,46620,443,allow,322265,12756,309509,409,270,173,236,1,"High deviation in pkts_sent, Bytes Received, Bytes"
62711,443,43946,443,allow,266781,12334,254447,323,161,119,204,1,"High deviation in pkts_sent, Bytes Received, Bytes"
57275,443,62988,443,allow,45483074,398771,45084303,36307,333,3386,32921,1,"High deviation in pkts_sent, Bytes Received, Bytes"
56766,443,14480,443,allow,10137,4019,6118,42,8169,24,18,1,"High deviation in pkts_sent, Elapsed Time (sec), Bytes Sent"
6881,52563,53881,52563,allow,228,118,110,2,1199,1,1,1,"High deviation in NAT Destination Port, Destination Port, Elapsed Time (sec)"
53749,53572,44841,53572,allow,492,306,186,8,15,5,3,1,"High deviation in pkts_sent, NAT Destination Port, Destination Port"
21133,26205,8150,26205,allow,480,149,331,2,1200,1,1,1,"High deviation in NAT Destination Port, Elapsed Time (sec), Destination Port"
50584,53743,42258,53743,allow,1356,300,1056,6,1201,3,3,1,"High deviation in pkts_sent, NAT Destination Port, Destination Port"
33013,443,50966,443,allow,88895,4807,84088,104,136,37,67,1,"High deviation in pkts_sent, Bytes Received, Bytes"
30960,45743,2927,45743,allow,330,330,0,6,3609,6,0,1,"High deviation in pkts_sent, NAT Destination Port, Elapsed Time (sec)"
37965,46994,50866,46994,allow,4089,2456,1633,53,1773,31,22,1,"High deviation in pkts_sent, NAT Destination Port, Destination Port"
38690,443,51124,443,allow,1107678,21465,1086213,1058,16,312,746,1,"High deviation in pkts_sent, Bytes Received, Bytes"
27005,50019,16642,50019,allow,877,126,751,2,30,1,1,1,"High deviation in NAT Destination Port, Destination Port, Bytes Received"
46299,443,43257,443,allow,648083,28117,619966,751,30,323,428,1,"High deviation in pkts_sent, Bytes Received, Bytes"
60450,56494,22867,56494,allow,70,70,0,2,8,2,0,1,"High deviation in pkts_sent, NAT Destination Port, Destination Port"
55080,80,25795,80,allow,2305712,80795,2224917,2771,52,1293,1478,1,"High deviation in pkts_sent, Bytes Received, Bytes"
57470,22796,55699,22796,allow,2224,1852,372,33,1565,27,6,1,"High deviation in pkts_sent, NAT Destination Port, Elapsed Time (sec)"
57470,26247,60262,26247,allow,1320,1320,0,21,1624,21,0,1,"High deviation in pkts_sent, NAT Destination Port, Elapsed Time (sec)"
6882,27032,16689,27032,allow,1200,1200,0,9,1201,9,0,1,"High deviation in pkts_sent, NAT Destination Port, Elapsed Time (sec)"
52607,443,60417,443,allow,18341,14819,3522,59,1044,31,28,1,"High deviation in pkts_sent, Bytes Sent, Bytes"
49421,5228,11226,5228,allow,8399,1901,6498,39,1562,16,23,1,"High deviation in pkts_sent, Elapsed Time (sec), NAT Destination Port"
50265,34311,31562,34311,allow,480,149,331,2,1200,1,1,1,"High deviation in NAT Destination Port, Destination Port, Elapsed Time (sec)"
30960,45742,3769,45742,allow,330,330,0,6,3609,6,0,1,"High deviation in pkts_sent, NAT Destination Port, Elapsed Time (sec)"
44847,51413,1303,51413,allow,475,150,325,2,1200,1,1,1,"High deviation in NAT Destination Port, Destination Port, Elapsed Time (sec)"
30960,45741,31412,45741,allow,330,330,0,6,3609,6,0,1,"High deviation in pkts_sent, NAT Destination Port, Elapsed Time (sec)"
50427,443,32859,443,allow,783009,84254,698755,776,706,250,526,1,"High deviation in pkts_sent, Bytes Received, Bytes"
17750,44597,35749,44597,allow,481,150,331,2,1200,1,1,1,"High deviation in NAT Destination Port, Destination Port, Elapsed Time (sec)"
65493,443,45559,443,allow,438968,12780,426188,449,16,157,292,1,"High deviation in pkts_sent, Bytes Received, Bytes"
36406,5228,24879,5228,allow,17762,4403,13359,92,616,47,45,1,"High deviation in pkts_sent, Bytes Sent, Bytes"
63923,59177,22656,59177,allow,70,70,0,1,4,1,0,1,"High deviation in NAT Destination Port, Destination Port, Source Port"
65494,443,61063,443,allow,92044,4379,87665,102,16,37,65,1,"High deviation in pkts_sent, Bytes Received, Bytes"
49650,443,26849,443,allow,92597,47158,45439,747,1187,422,325,1,"High deviation in pkts_sent, Bytes Sent, Bytes"
51667,25826,43054,25826,allow,9415,9415,0,11,30,11,0,1,"High deviation in pkts_sent, NAT Destination Port, Bytes Sent"
39115,443,62542,443,allow,335190,17497,317693,449,42,211,238,1,"High deviation in pkts_sent, Bytes Received, Bytes"
56553,443,45538,443,allow,116577,6817,109760,137,62,54,83,1,"High deviation in pkts_sent, Bytes Received, Bytes"
53118,443,63279,443,allow,21933,11660,10273,206,188,114,92,1,"High deviation in pkts_sent, Bytes Sent, Bytes"
62387,80,62387,80,allow,548903,4452,544451,440,20,58,382,1,"High deviation in pkts_sent, Bytes Received, Bytes"
58853,443,20470,443,allow,155516,6298,149218,174,107,49,125,1,"High deviation in pkts_sent, Bytes Received, Bytes"
50444,443,31610,443,allow,47752,21819,25933,119,704,59,60,1,"High deviation in pkts_sent, Bytes Sent, Bytes"
53742,63344,47218,63344,allow,1294,797,497,13,15,7,6,1,"High deviation in pkts_sent, NAT Destination Port, Destination Port"
49191,51253,24345,51253,allow,504,318,186,8,15,5,3,1,"High deviation in pkts_sent, NAT Destination Port, Destination Port"
48346,443,9051,443,allow,2272788,106549,2166239,2492,190,850,1642,1,"High deviation in pkts_sent, Bytes Received, Bytes"
5240,36828,56682,36828,allow,166456,128,166328,270,35,3,267,1,"High deviation in pkts_sent, Bytes Received, Bytes"
10151,22208,55626,22208,allow,323,150,173,2,1203,1,1,1,"High deviation in NAT Destination Port, Elapsed Time (sec), Destination Port"
57402,9992,42519,9992,allow,47040,13931,33109,428,129,207,221,1,"High deviation in pkts_sent, Bytes Sent, Bytes"
52168,443,14996,443,allow,73105,13398,59707,220,374,108,112,1,"High deviation in pkts_sent, Bytes Received, Bytes"
38122,443,65050,443,allow,191454,11241,180213,262,42,128,134,1,"High deviation in pkts_sent, Bytes Received, Bytes"
50932,443,17054,443,allow,167483,7402,160081,221,23,93,128,1,"High deviation in pkts_sent, Bytes Received, Bytes"
36688,443,22490,443,allow,86101,7312,78789,145,128,63,82,1,"High deviation in pkts_sent, Bytes Received, Bytes"
48343,443,59139,443,allow,1985333,91427,1893906,2159,190,721,1438,1,"High deviation in pkts_sent, Bytes Received, Bytes"
58391,443,1299,443,allow,347192,61325,285867,643,191,297,346,1,"High deviation in pkts_sent, Bytes Received, Bytes"
58396,443,53120,443,allow,138065,109491,28574,429,186,230,199,1,"High deviation in pkts_sent, Bytes Sent, Bytes"
48345,443,50795,443,allow,940826,59470,881356,1101,190,412,689,1,"High deviation in pkts_sent, Bytes Received, Bytes"
49737,443,51096,443,allow,334252,14917,319335,405,73,179,226,1,"High deviation in pkts_sent, Bytes Received, Bytes"
48344,443,64214,443,allow,2588313,95154,2493159,2645,190,811,1834,1,"High deviation in pkts_sent, Bytes Received, Bytes"
53629,443,28491,443,allow,123122,115571,7551,161,23,93,68,1,"High deviation in pkts_sent, Bytes Sent, Bytes"
30188,58770,26804,58770,allow,14172,5733,8439,79,1531,37,42,1,"High deviation in pkts_sent, NAT Destination Port, Bytes Sent"
51960,58601,12629,58601,allow,70,70,0,2,8,2,0,1,"High deviation in pkts_sent, NAT Destination Port, Destination Port"
52992,443,3497,443,allow,97763,8230,89533,131,150,49,82,1,"High deviation in pkts_sent, Bytes Received, Bytes"
37965,28596,25273,28596,allow,479,150,329,2,1199,1,1,1,"High deviation in NAT Destination Port, Elapsed Time (sec), Destination Port"
57470,54058,20688,54058,allow,150,150,0,1,1199,1,0,1,"High deviation in NAT Destination Port, Destination Port, Elapsed Time (sec)"
63917,57826,39527,57826,allow,70,70,0,1,5,1,0,1,"High deviation in NAT Destination Port, Destination Port, NAT Source Port"
63651,443,19234,443,allow,333668,12291,321377,321,170,72,249,1,"High deviation in pkts_sent, Bytes Received, Bytes"
5232,46495,40739,46495,allow,832,832,0,14,96,14,0,1,"High deviation in pkts_sent, NAT Destination Port, Destination Port"
53144,58987,43141,58987,allow,70,70,0,2,8,2,0,1,"High deviation in pkts_sent, NAT Destination Port, Destination Port"
53140,64128,33195,64128,allow,698,320,378,10,17,6,4,1,"High deviation in pkts_sent, NAT Destination Port, Destination Port"
5231,30114,20445,30114,allow,832,832,0,14,96,14,0,1,"High deviation in pkts_sent, NAT Destination Port, Destination Port"
45641,443,12763,443,allow,99276,88410,10866,143,333,78,65,1,"High deviation in pkts_sent, Bytes Sent, Bytes"
6881,41872,4010,41872,allow,509,150,359,2,1200,1,1,1,"High deviation in NAT Destination Port, Destination Port, Elapsed Time (sec)"
30960,45738,57653,45738,allow,396,396,0,7,3615,7,0,1,"High deviation in pkts_sent, NAT Destination Port, Elapsed Time (sec)"
57470,45561,33811,45561,allow,792,792,0,13,1201,13,0,1,"High deviation in pkts_sent, NAT Destination Port, Destination Port"
49160,51839,39818,51839,allow,868,150,718,4,1200,2,2,1,"High deviation in pkts_sent, NAT Destination Port, Destination Port"
35925,443,8324,443,allow,1092248,9101,1083147,860,195,111,749,1,"High deviation in pkts_sent, Bytes Received, Bytes"
56806,443,47180,443,allow,403093,31796,371297,497,151,185,312,1,"High deviation in pkts_sent, Bytes Received, Bytes"
52324,443,60831,443,allow,295493,16052,279441,394,68,186,208,1,"High deviation in pkts_sent, Bytes Received, Bytes"
54067,443,60829,443,allow,113020,6140,106880,149,202,66,83,1,"High deviation in pkts_sent, Bytes Received, Bytes"
63916,56318,63492,56318,allow,70,70,0,1,4,1,0,1,"High deviation in NAT Destination Port, Destination Port, NAT Source Port"
57470,64108,16646,64108,allow,330,330,0,6,1199,6,0,1,"High deviation in pkts_sent, NAT Destination Port, Destination Port"
52323,443,4848,443,allow,454059,23387,430672,602,76,275,327,1,"High deviation in pkts_sent, Bytes Received, Bytes"
54194,443,38493,443,allow,195229,13204,182025,270,124,102,168,1,"High deviation in pkts_sent, Bytes Received, Bytes"
54066,443,63244,443,allow,307208,13249,293959,367,202,153,214,1,"High deviation in pkts_sent, Bytes Received, Bytes"
54073,443,61123,443,allow,90387,4941,85446,123,170,54,69,1,"High deviation in pkts_sent, Bytes Received, Bytes"
40709,443,57804,443,allow,256802,11839,244963,329,173,136,193,1,"High deviation in pkts_sent, Bytes Received, Bytes"
50265,44843,10747,44843,allow,70,70,0,1,1200,1,0,1,"High deviation in NAT Destination Port, Destination Port, Elapsed Time (sec)"
63935,51413,5308,51413,allow,312,132,180,6,7,3,3,1,"High deviation in pkts_sent, NAT Destination Port, Destination Port"
38848,80,21726,80,allow,288702,9850,278852,312,105,123,189,1,"High deviation in pkts_sent, Bytes Received, Bytes"
50406,8080,50406,8080,allow,47078,2874,44204,66,51,32,34,1,"High deviation in pkts_sent, Bytes Received, Bytes"
41061,5222,19047,5222,allow,107717,16808,90909,301,618,148,153,1,"High deviation in pkts_sent, Bytes Received, Bytes"
61503,443,25661,443,allow,182448,3931,178517,161,26,36,125,1,"High deviation in pkts_sent, Bytes Received, Bytes"
56216,5228,61293,5228,allow,2495,1477,1018,17,3600,8,9,1,"High deviation in pkts_sent, Elapsed Time (sec), NAT Destination Port"
62275,443,20241,443,allow,18482489,568378,17914111,19386,214,6466,12920,1,"High deviation in pkts_sent, Bytes Received, Bytes"
49421,443,23073,443,allow,301494,6917,294577,306,48,101,205,1,"High deviation in pkts_sent, Bytes Received, Bytes"
51927,63309,60569,63309,allow,70,70,0,1,5,1,0,1,"High deviation in NAT Destination Port, Destination Port, NAT Source Port"
37965,48477,53954,48477,allow,7097,4720,2377,89,3163,55,34,1,"High deviation in pkts_sent, NAT Destination Port, Elapsed Time (sec)"
54453,443,34094,443,allow,257837,37453,220384,446,952,175,271,1,"High deviation in pkts_sent, Bytes Received, Bytes"
51539,443,52838,443,allow,94949,5974,88975,118,148,45,73,1,"High deviation in pkts_sent, Bytes Received, Bytes"
36483,80,36483,80,allow,1015966,37923,978043,1167,205,468,699,1,"High deviation in pkts_sent, Bytes Received, Bytes"
51951,65387,56923,65387,allow,70,70,0,2,8,2,0,1,"High deviation in pkts_sent, NAT Destination Port, Destination Port"
27005,50003,14417,50003,allow,887,126,761,2,31,1,1,1,"High deviation in NAT Destination Port, Destination Port, Bytes Received"
34319,443,65277,443,allow,15358,11148,4210,93,423,51,42,1,"High deviation in pkts_sent, Bytes Sent, Bytes"
6881,6889,64062,6889,allow,228,118,110,2,1199,1,1,1,"High deviation in NAT Destination Port, Elapsed Time (sec), Destination Port"
57470,52215,48091,52215,allow,528,528,0,9,1200,9,0,1,"High deviation in pkts_sent, NAT Destination Port, Destination Port"
55669,62781,37625,62781,allow,320,140,180,6,7,3,3,1,"High deviation in pkts_sent, NAT Destination Port, Destination Port"
51957,56737,56106,56737,allow,316,136,180,6,6,3,3,1,"High deviation in pkts_sent, NAT Destination Port, Destination Port"
56722,80,63327,80,allow,41658,23230,18428,114,798,66,48,1,"High deviation in pkts_sent, Bytes Sent, Bytes"
50494,443,62791,443,allow,5331564,43954,5287610,4171,80,672,3499,1,"High deviation in pkts_sent, Bytes Received, Bytes"
51221,50861,60298,50861,allow,490,149,341,2,1200,1,1,1,"High deviation in NAT Destination Port, Destination Port, Elapsed Time (sec)"
30960,45740,3924,45740,allow,330,330,0,6,3609,6,0,1,"High deviation in pkts_sent, NAT Destination Port, Elapsed Time (sec)"
51926,58664,64074,58664,allow,70,70,0,1,5,1,0,1,"High deviation in NAT Destination Port, Destination Port, NAT Source Port"
65322,443,20624,443,allow,8429792,268889,8160903,8985,135,2983,6002,1,"High deviation in pkts_sent, Bytes Received, Bytes"
36699,443,33647,443,allow,11086707,166045,10920662,9176,172,1285,7891,1,"High deviation in pkts_sent, Bytes Received, Bytes"
56919,443,47014,443,allow,54568,32686,21882,69,161,40,29,1,"High deviation in pkts_sent, Bytes Sent, Bytes"
38689,443,13215,443,allow,1264333,25315,1239018,1197,16,355,842,1,"High deviation in pkts_sent, Bytes Received, Bytes"
15503,6881,43362,6881,allow,2310,2310,0,36,3136,36,0,1,"High deviation in pkts_sent, Elapsed Time (sec), NAT Destination Port"
44960,443,32145,443,allow,306066,33556,272510,414,196,162,252,1,"High deviation in pkts_sent, Bytes Received, Bytes"
57862,443,61289,443,allow,448344,11729,436615,474,157,128,346,1,"High deviation in pkts_sent, Bytes Received, Bytes"
38125,443,63227,443,allow,497663,22937,474726,585,38,245,340,1,"High deviation in pkts_sent, Bytes Received, Bytes"
50021,80,33696,80,allow,10026538,185017,9841521,9515,195,2989,6526,1,"High deviation in pkts_sent, Bytes Received, Bytes"
55432,443,59316,443,allow,256189,15094,241095,316,122,120,196,1,"High deviation in pkts_sent, Bytes Received, Bytes"
63976,443,11736,443,allow,1270998,514773,756225,3073,2384,1413,1660,1,"High deviation in pkts_sent, Bytes Sent, Bytes"
36438,5223,19564,5223,allow,5243,1898,3345,34,3005,18,16,1,"High deviation in pkts_sent, Elapsed Time (sec), NAT Destination Port"
56574,443,27778,443,allow,75732,15030,60702,137,138,56,81,1,"High deviation in pkts_sent, Bytes Received, Bytes"
30960,45739,64773,45739,allow,330,330,0,6,3609,6,0,1,"High deviation in pkts_sent, NAT Destination Port, Elapsed Time (sec)"
30960,45736,51969,45736,allow,396,396,0,7,3616,7,0,1,"High deviation in pkts_sent, NAT Destination Port, Elapsed Time (sec)"
51221,57274,16024,57274,allow,528,528,0,9,1201,9,0,1,"High deviation in pkts_sent, NAT Destination Port, Destination Port"
60442,49556,41273,49556,allow,624,318,306,10,15,5,5,1,"High deviation in pkts_sent, NAT Destination Port, Destination Port"
65491,443,49902,443,allow,452013,13200,438813,465,16,163,302,1,"High deviation in pkts_sent, Bytes Received, Bytes"
51953,62964,9503,62964,allow,316,136,180,6,5,3,3,1,"High deviation in pkts_sent, NAT Destination Port, Destination Port"
63899,62015,51023,62015,allow,70,70,0,1,4,1,0,1,"High deviation in NAT Destination Port, Destination Port, NAT Source Port"
65492,443,42698,443,allow,92573,4519,88054,105,16,39,66,1,"High deviation in pkts_sent, Bytes Received, Bytes"
38112,443,61056,443,allow,1053962,45604,1008358,1190,69,456,734,1,"High deviation in pkts_sent, Bytes Received, Bytes"
55654,443,49899,443,allow,186406,10415,175991,218,123,79,139,1,"High deviation in pkts_sent, Bytes Received, Bytes"
61887,443,28383,443,allow,81136,7785,73351,109,131,40,69,1,"High deviation in pkts_sent, Bytes Received, Bytes"
6882,4443,56989,4443,allow,600,600,0,5,1200,5,0,1,"High deviation in pkts_sent, NAT Destination Port, Elapsed Time (sec)"
19473,35726,44271,35726,allow,481,150,331,2,1200,1,1,1,"High deviation in NAT Destination Port, Destination Port, Elapsed Time (sec)"
30188,63853,28721,63853,allow,502,150,352,2,1200,1,1,1,"High deviation in NAT Destination Port, Destination Port, Elapsed Time (sec)"
50266,443,41683,443,allow,49981,15486,34495,269,138,136,133,1,"High deviation in pkts_sent, Bytes Sent, Bytes"
50268,443,33459,443,allow,35251,25181,10070,121,123,63,58,1,"High deviation in pkts_sent, Bytes Sent, Bytes"
51221,33295,49216,33295,allow,528,528,0,9,1200,9,0,1,"High deviation in pkts_sent, NAT Destination Port, Destination Port"
53724,64923,63918,64923,allow,70,70,0,1,5,1,0,1,"High deviation in NAT Destination Port, Destination Port, NAT Source Port"
49322,443,12551,443,allow,166663,77974,88689,368,2310,123,245,1,"High deviation in pkts_sent, Bytes Sent, Bytes"
50265,26650,50101,26650,allow,480,149,331,2,1201,1,1,1,"High deviation in NAT Destination Port, Elapsed Time (sec), Destination Port"
50535,80,30581,80,allow,62768,25796,36972,75,34,33,42,1,"High deviation in pkts_sent, Bytes Sent, Bytes"
60436,56687,61011,56687,allow,564,318,246,9,16,5,4,1,"High deviation in pkts_sent, NAT Destination Port, Destination Port"
63923,59177,7249,59177,allow,66,66,0,2,7,2,0,1,"High deviation in pkts_sent, NAT Destination Port, Destination Port"
55446,443,18400,443,allow,165191,6141,159050,184,30,67,117,1,"High deviation in pkts_sent, Bytes Received, Bytes"
37983,443,26799,443,allow,15668921,169545,15499376,12539,161,1284,11255,1,"High deviation in pkts_sent, Bytes Received, Bytes"
60336,5222,43827,5222,allow,32653,15160,17493,307,506,160,147,1,"High deviation in pkts_sent, Bytes Sent, Bytes"
63092,443,8576,443,allow,4771341,155341,4616000,5024,147,1667,3357,1,"High deviation in pkts_sent, Bytes Received, Bytes"
49890,443,49782,443,allow,2513598,90400,2423198,2658,280,896,1762,1,"High deviation in pkts_sent, Bytes Received, Bytes"
49280,80,50074,80,allow,200808,6612,194196,217,3669,83,134,1,"High deviation in pkts_sent, Bytes Received, Bytes"
21133,41620,37961,41620,allow,150,150,0,1,1199,1,0,1,"High deviation in NAT Destination Port, Destination Port, Elapsed Time (sec)"
35221,443,12640,443,allow,146299,21774,124525,246,141,98,148,1,"High deviation in pkts_sent, Bytes Received, Bytes"
50257,443,7570,443,allow,249660,21361,228299,416,141,191,225,1,"High deviation in pkts_sent, Bytes Received, Bytes"
50263,443,33451,443,allow,35817,18303,17514,160,138,85,75,1,"High deviation in pkts_sent, Bytes Sent, Bytes"
55444,443,59927,443,allow,1455177,56285,1398892,1600,31,632,968,1,"High deviation in pkts_sent, Bytes Received, Bytes"
51982,80,47547,80,allow,14487990,289826,14198164,13259,54,3839,9420,1,"High deviation in pkts_sent, Bytes Received, Bytes"
58982,443,29770,443,allow,6400453,202937,6197516,6806,226,2259,4547,1,"High deviation in pkts_sent, Bytes Received, Bytes"
43827,443,38851,443,allow,677212,30094,647118,785,136,282,503,1,"High deviation in pkts_sent, Bytes Received, Bytes"
6881,58293,28909,58293,allow,228,118,110,2,1200,1,1,1,"High deviation in NAT Destination Port, Destination Port, Elapsed Time (sec)"
55449,443,46191,443,allow,480989,16896,464093,507,22,178,329,1,"High deviation in pkts_sent, Bytes Received, Bytes"
60441,64337,24616,64337,allow,70,70,0,1,5,1,0,1,"High deviation in NAT Destination Port, Destination Port, NAT Source Port"
55445,443,10778,443,allow,1373295,46189,1327106,1448,31,527,921,1,"High deviation in pkts_sent, Bytes Received, Bytes"
60971,443,28807,443,allow,396507,14667,381840,458,21,171,287,1,"High deviation in pkts_sent, Bytes Received, Bytes"
57470,41013,23995,41013,allow,2128,875,1253,26,1980,13,13,1,"High deviation in pkts_sent, NAT Destination Port, Elapsed Time (sec)"
50022,80,11593,80,allow,10023148,180272,9842876,9438,193,2907,6531,1,"High deviation in pkts_sent, Bytes Received, Bytes"
44402,443,62685,443,allow,196732,11940,184792,257,139,103,154,1,"High deviation in pkts_sent, Bytes Received, Bytes"
53755,45416,43327,45416,allow,320,140,180,6,6,3,3,1,"High deviation in pkts_sent, NAT Destination Port, Destination Port"
57499,80,57499,80,allow,343853,13570,330283,445,3,223,222,1,"High deviation in pkts_sent, Bytes Received, Bytes"
5239,6064,8462,6064,allow,217199,128,217071,316,37,3,313,1,"High deviation in pkts_sent, Bytes Received, Bytes"
50575,443,8721,443,allow,149414,8612,140802,208,25,107,101,1,"High deviation in pkts_sent, Bytes Received, Bytes"
58744,443,37896,443,allow,42954,12409,30545,154,319,67,87,1,"High deviation in pkts_sent, Bytes Sent, Bytes"
14692,443,14692,443,allow,95958,6670,89288,139,80,68,71,1,"High deviation in pkts_sent, Bytes Received, Bytes"
60381,80,60381,80,allow,448865,6437,442428,380,151,67,313,1,"High deviation in pkts_sent, Bytes Received, Bytes"
15503,62336,46736,62336,allow,127653507,122661116,4992391,161030,2162,82907,78123,1,"High deviation in pkts_sent, Bytes Sent, Bytes"
53715,62348,45392,62348,allow,672,306,366,11,14,5,6,1,"High deviation in pkts_sent, NAT Destination Port, Destination Port"
55664,45682,37882,45682,allow,320,140,180,6,6,3,3,1,"High deviation in pkts_sent, NAT Destination Port, Destination Port"
49186,443,54954,443,allow,508520,13734,494786,527,18,192,335,1,"High deviation in pkts_sent, Bytes Received, Bytes"
60978,443,39156,443,allow,1004246,35992,968254,1127,90,451,676,1,"High deviation in pkts_sent, Bytes Received, Bytes"
49972,80,64274,80,allow,95065,52092,42973,148,259,77,71,1,"High deviation in pkts_sent, Bytes Sent, Bytes"
49589,443,40471,443,allow,327575,8400,319175,334,316,113,221,1,"High deviation in pkts_sent, Bytes Received, Bytes"
17750,50321,45531,50321,allow,491,150,341,2,1200,1,1,1,"High deviation in NAT Destination Port, Destination Port, Elapsed Time (sec)"
38115,443,13490,443,allow,281978,16098,265880,405,67,204,201,1,"High deviation in pkts_sent, Bytes Received, Bytes"
52146,443,52659,443,allow,774806,25835,748971,772,52,253,519,1,"High deviation in pkts_sent, Bytes Received, Bytes"
9172,443,4913,443,allow,89362,3092,86270,100,21,37,63,1,"High deviation in pkts_sent, Bytes Received, Bytes"
14137,443,14137,443,allow,155070,7155,147915,186,81,74,112,1,"High deviation in pkts_sent, Bytes Received, Bytes"
59792,80,7891,80,allow,1453540,37280,1416260,1552,96,507,1045,1,"High deviation in pkts_sent, Bytes Received, Bytes"
49448,443,41135,443,allow,186882,17018,169864,206,29,84,122,1,"High deviation in pkts_sent, Bytes Received, Bytes"
39118,443,64547,443,allow,206769,6309,200460,215,27,77,138,1,"High deviation in pkts_sent, Bytes Received, Bytes"
56698,443,19362,443,allow,106055,8460,97595,168,26,79,89,1,"High deviation in pkts_sent, Bytes Received, Bytes"
60241,443,3002,443,allow,92975,3289,89686,107,316,40,67,1,"High deviation in pkts_sent, Bytes Received, Bytes"
45896,443,44655,443,allow,211720,46699,165021,332,109,152,180,1,"High deviation in pkts_sent, Bytes Received, Bytes"
50128,80,27649,80,allow,20575,11455,9120,92,966,47,45,1,"High deviation in pkts_sent, Bytes Sent, Bytes"
60443,50284,16097,50284,allow,258,70,188,4,8,2,2,1,"High deviation in pkts_sent, NAT Destination Port, Destination Port"
38612,443,17131,443,allow,20651533,655694,19995839,24885,362,8746,16139,1,"High deviation in pkts_sent, Bytes Received, Bytes"
38608,443,19892,443,allow,17473899,604274,16869625,22165,408,7731,14434,1,"High deviation in pkts_sent, Bytes Received, Bytes"
38610,443,57889,443,allow,19092095,654744,18437351,24079,407,8531,15548,1,"High deviation in pkts_sent, Bytes Received, Bytes"
51910,60443,42638,60443,allow,66,66,0,1,5,1,0,1,"High deviation in NAT Destination Port, Destination Port, NAT Source Port"
6881,12999,32088,12999,allow,622,356,266,4,1201,2,2,1,"High deviation in pkts_sent, NAT Destination Port, Elapsed Time (sec)"
46285,443,49897,443,allow,36209,28887,7322,65,364,34,31,1,"High deviation in pkts_sent, Bytes Sent, Bytes"
49484,443,58905,443,allow,407843,11895,395948,436,271,157,279,1,"High deviation in pkts_sent, Bytes Received, Bytes"
57239,5228,64844,5228,allow,16135,7514,8621,173,9115,72,101,1,"High deviation in pkts_sent, Elapsed Time (sec), Bytes Sent"
50265,59362,35253,59362,allow,4228,2471,1757,55,2758,31,24,1,"High deviation in pkts_sent, NAT Destination Port, Elapsed Time (sec)"
41320,443,41281,443,allow,1743946,54876,1689070,1870,360,678,1192,1,"High deviation in pkts_sent, Bytes Received, Bytes"
63916,56318,49851,56318,allow,66,66,0,2,7,2,0,1,"High deviation in pkts_sent, NAT Destination Port, Destination Port"
63917,57826,24551,57826,allow,66,66,0,2,7,2,0,1,"High deviation in pkts_sent, NAT Destination Port, Destination Port"
49753,80,62550,80,allow,32910,18450,14460,143,1647,75,68,1,"High deviation in pkts_sent, Bytes Sent, Bytes"
53087,443,59846,443,allow,408922,10621,398301,421,121,145,276,1,"High deviation in pkts_sent, Bytes Received, Bytes"
50661,443,13443,443,allow,298067,6719,291348,307,17,98,209,1,"High deviation in pkts_sent, Bytes Received, Bytes"
49347,443,51852,443,allow,611644,29314,582330,793,132,333,460,1,"High deviation in pkts_sent, Bytes Received, Bytes"
36413,443,33262,443,allow,2064683,47545,2017138,1994,33,657,1337,1,"High deviation in pkts_sent, Bytes Received, Bytes"
63572,443,58406,443,allow,125798,40014,85784,276,171,125,151,1,"High deviation in pkts_sent, Bytes Sent, Bytes"
48022,5228,46270,5228,allow,10096,2251,7845,41,3747,16,25,1,"High deviation in pkts_sent, Elapsed Time (sec), Bytes Received"
51905,65253,44295,65253,allow,66,66,0,1,5,1,0,1,"High deviation in NAT Destination Port, Destination Port, NAT Source Port"
50469,80,50469,80,allow,350722,14506,336216,459,26,231,228,1,"High deviation in pkts_sent, Bytes Received, Bytes"
58888,443,13119,443,allow,274616,12640,261976,352,28,167,185,1,"High deviation in pkts_sent, Bytes Received, Bytes"
30960,45737,31575,45737,allow,330,330,0,6,3609,6,0,1,"High deviation in pkts_sent, NAT Destination Port, Elapsed Time (sec)"
58124,80,58124,80,allow,125299,3364,121935,129,19,44,85,1,"High deviation in pkts_sent, Bytes Received, Bytes"
48817,47719,48817,47719,allow,1837,852,985,8,1200,4,4,1,"High deviation in pkts_sent, NAT Destination Port, Destination Port"
63598,443,20938,443,allow,164604,5676,158928,188,39,70,118,1,"High deviation in pkts_sent, Bytes Received, Bytes"
37965,29299,52257,29299,allow,858,858,0,14,1199,14,0,1,"High deviation in pkts_sent, NAT Destination Port, Elapsed Time (sec)"
51928,52520,20049,52520,allow,258,70,188,4,8,2,2,1,"High deviation in pkts_sent, NAT Destination Port, Destination Port"
60444,47094,7095,47094,allow,320,140,180,6,7,3,3,1,"High deviation in pkts_sent, NAT Destination Port, Destination Port"
42615,443,10393,443,allow,117381,60398,56983,518,4126,256,262,1,"High deviation in pkts_sent, Bytes Sent, Bytes"
38425,443,45581,443,allow,103112,8212,94900,165,55,80,85,1,"High deviation in pkts_sent, Bytes Received, Bytes"
51927,63309,55046,63309,allow,70,70,0,2,8,2,0,1,"High deviation in pkts_sent, NAT Destination Port, Destination Port"
49348,443,47501,443,allow,2879984,113967,2766017,3396,129,1423,1973,1,"High deviation in pkts_sent, Bytes Received, Bytes"
53706,59208,42614,59208,allow,164,70,94,2,8,1,1,1,"High deviation in NAT Destination Port, Destination Port, NAT Source Port"
53707,44209,9971,44209,allow,1513,989,524,17,16,10,7,1,"High deviation in pkts_sent, NAT Destination Port, Destination Port"
38685,443,17432,443,allow,749731,23099,726632,823,16,326,497,1,"High deviation in pkts_sent, Bytes Received, Bytes"
55517,443,55517,443,allow,274414,45529,228885,359,170,186,173,1,"High deviation in pkts_sent, Bytes Received, Bytes"
47733,443,46776,443,allow,556154,55291,500863,1146,559,440,706,1,"High deviation in pkts_sent, Bytes Received, Bytes"
54455,443,54455,443,allow,324001,46592,277409,409,177,203,206,1,"High deviation in pkts_sent, Bytes Received, Bytes"
35061,80,46318,80,allow,15651782,355118,15296664,15172,45,5065,10107,1,"High deviation in pkts_sent, Bytes Received, Bytes"
47119,5228,18356,5228,allow,3630,2427,1203,21,3601,11,10,1,"High deviation in pkts_sent, Elapsed Time (sec), NAT Destination Port"
53088,443,43774,443,allow,161938,137946,23992,412,384,227,185,1,"High deviation in pkts_sent, Bytes Sent, Bytes"
57470,39113,45501,39113,allow,14689,8867,5822,93,3051,67,26,1,"High deviation in pkts_sent, NAT Destination Port, Bytes Sent"
47821,443,31829,443,allow,71624,60795,10829,194,131,110,84,1,"High deviation in pkts_sent, Bytes Sent, Bytes"
65489,443,61860,443,allow,92240,4799,87441,107,16,43,64,1,"High deviation in pkts_sent, Bytes Received, Bytes"
65490,443,45608,443,allow,405489,12010,393479,416,16,146,270,1,"High deviation in pkts_sent, Bytes Received, Bytes"
30188,39920,5702,39920,allow,501,150,351,2,1200,1,1,1,"High deviation in NAT Destination Port, Destination Port, Elapsed Time (sec)"
53232,443,40771,443,allow,69742,34581,35161,105,63,52,53,1,"High deviation in pkts_sent, Bytes Sent, Bytes"
33825,443,12586,443,allow,15400,12233,3167,75,995,38,37,1,"High deviation in pkts_sent, Bytes Sent, Bytes"
53735,58869,2598,58869,allow,70,70,0,2,7,2,0,1,"High deviation in pkts_sent, NAT Destination Port, Destination Port"
52858,443,52858,443,allow,313243,267937,45306,456,5925,210,246,1,"High deviation in pkts_sent, Bytes Sent, Bytes"
51926,58664,36241,58664,allow,70,70,0,2,8,2,0,1,"High deviation in pkts_sent, NAT Destination Port, Destination Port"
15503,63684,7728,63684,allow,481,150,331,2,1200,1,1,1,"High deviation in NAT Destination Port, Destination Port, Elapsed Time (sec)"
63899,62015,4677,62015,allow,66,66,0,2,8,2,0,1,"High deviation in pkts_sent, NAT Destination Port, Destination Port"
57470,62348,3608,62348,allow,149,149,0,1,1200,1,0,1,"High deviation in NAT Destination Port, Destination Port, Elapsed Time (sec)"
58908,443,56510,443,allow,6278402,111931,6166471,5306,1119,732,4574,1,"High deviation in pkts_sent, Bytes Received, Bytes"
37965,33738,46824,33738,allow,1548,265,1283,4,1200,2,2,1,"High deviation in pkts_sent, NAT Destination Port, Destination Port"
60957,443,60957,443,allow,70839,5466,65373,98,19,47,51,1,"High deviation in pkts_sent, Bytes Received, Bytes"
8881,443,2247,443,allow,27459,19126,8333,67,402,30,37,1,"High deviation in pkts_sent, Bytes Sent, Bytes"
50653,80,33144,80,allow,124643,7017,117626,163,21,75,88,1,"High deviation in pkts_sent, Bytes Received, Bytes"
46763,443,11187,443,allow,11876848,256539,11620309,11266,74,3584,7682,1,"High deviation in pkts_sent, Bytes Received, Bytes"
55022,80,15142,80,allow,1080714,29230,1051484,1137,174,436,701,1,"High deviation in pkts_sent, Bytes Received, Bytes"
55249,443,62038,443,allow,3056958,73055,2983903,3016,43,1023,1993,1,"High deviation in pkts_sent, Bytes Received, Bytes"
50265,49083,4910,49083,allow,132,132,0,3,1200,3,0,1,"High deviation in pkts_sent, NAT Destination Port, Destination Port"
50265,45682,34420,45682,allow,330,330,0,6,1200,6,0,1,"High deviation in pkts_sent, NAT Destination Port, Destination Port"
36476,5228,61709,5228,allow,21282,7311,13971,96,1216,47,49,1,"High deviation in pkts_sent, Bytes Sent, Bytes"
50265,35344,29716,35344,allow,1386,1386,0,22,2342,22,0,1,"High deviation in pkts_sent, NAT Destination Port, Elapsed Time (sec)"
50579,80,48781,80,allow,265114,13651,251463,346,76,161,185,1,"High deviation in pkts_sent, Bytes Received, Bytes"
10151,31964,38746,31964,allow,481,150,331,2,1200,1,1,1,"High deviation in NAT Destination Port, Destination Port, Elapsed Time (sec)"
44354,80,44354,80,allow,250076,10158,239918,315,24,146,169,1,"High deviation in pkts_sent, Bytes Received, Bytes"
59932,443,1750,443,allow,333535,35190,298345,555,285,257,298,1,"High deviation in pkts_sent, Bytes Received, Bytes"
62929,443,8515,443,allow,46033,7524,38509,103,141,49,54,1,"High deviation in pkts_sent, Bytes Received, Bytes"
53724,64923,33470,64923,allow,70,70,0,2,8,2,0,1,"High deviation in pkts_sent, NAT Destination Port, Destination Port"
15503,58675,42815,58675,allow,2227,1224,1003,20,1200,11,9,1,"High deviation in pkts_sent, NAT Destination Port, Destination Port"
63877,51413,26586,51413,allow,564,382,182,9,18,6,3,1,"High deviation in pkts_sent, NAT Destination Port, Destination Port"
37965,61872,44512,61872,allow,1548,265,1283,4,1201,2,2,1,"High deviation in pkts_sent, NAT Destination Port, Destination Port"
55649,5228,61882,5228,allow,5378,2359,3019,35,3786,16,19,1,"High deviation in pkts_sent, Elapsed Time (sec), NAT Destination Port"
53318,56648,63034,56648,allow,672,432,240,10,142,6,4,1,"High deviation in pkts_sent, NAT Destination Port, Destination Port"
59680,80,46564,80,allow,5762500,128192,5634308,5613,134,1854,3759,1,"High deviation in pkts_sent, Bytes Received, Bytes"
63903,56016,63323,56016,allow,312,132,180,6,6,3,3,1,"High deviation in pkts_sent, NAT Destination Port, Destination Port"
60441,64337,31545,64337,allow,70,70,0,2,8,2,0,1,"High deviation in pkts_sent, NAT Destination Port, Destination Port"
50652,80,2519,80,allow,97934,5018,92916,124,20,55,69,1,"High deviation in pkts_sent, Bytes Received, Bytes"
50914,443,57800,443,allow,22211,8661,13550,173,854,77,96,1,"High deviation in pkts_sent, Bytes Sent, Bytes"
49184,443,9767,443,allow,493152,13222,479930,509,19,184,325,1,"High deviation in pkts_sent, Bytes Received, Bytes"
6881,60026,38643,60026,allow,509,150,359,2,1199,1,1,1,"High deviation in NAT Destination Port, Destination Port, Elapsed Time (sec)"
37965,44056,39211,44056,allow,158,158,0,1,1199,1,0,1,"High deviation in NAT Destination Port, Destination Port, Elapsed Time (sec)"
53760,443,58528,443,allow,13059,3730,9329,73,3729,32,41,1,"High deviation in pkts_sent, Elapsed Time (sec), Bytes Sent"
38118,443,33958,443,allow,574857,27894,546963,745,57,346,399,1,"High deviation in pkts_sent, Bytes Received, Bytes"
62723,443,17496,443,allow,126815,114702,12113,243,86,139,104,1,"High deviation in pkts_sent, Bytes Sent, Bytes"
50655,80,4984,80,allow,91198,3990,87208,113,19,49,64,1,"High deviation in pkts_sent, Bytes Received, Bytes"
49160,38098,52628,38098,allow,676,367,309,6,1200,3,3,1,"High deviation in pkts_sent, NAT Destination Port, Destination Port"
26081,53,34120,53,allow,75510,75228,282,904,90,902,2,1,"High deviation in pkts_sent, Bytes Sent, Packets"
26081,53,4535,53,allow,243667,236247,7420,2897,90,2851,46,1,"High deviation in pkts_sent, Bytes Sent, Packets"
19473,12430,61068,12430,allow,491,150,341,2,1200,1,1,1,"High deviation in NAT Destination Port, Elapsed Time (sec), Destination Port"
37965,51413,62222,51413,allow,158,158,0,1,1200,1,0,1,"High deviation in NAT Destination Port, Destination Port, Elapsed Time (sec)"
21133,39263,6580,39263,allow,323,150,173,2,1200,1,1,1,"High deviation in NAT Destination Port, Destination Port, Elapsed Time (sec)"
55655,63670,50631,63670,allow,70,70,0,1,5,1,0,1,"High deviation in NAT Destination Port, Destination Port, NAT Source Port"
40309,443,48693,443,allow,51588,40242,11346,107,418,53,54,1,"High deviation in pkts_sent, Bytes Sent, Bytes"
45964,59999,45964,59999,allow,60,60,0,1,5,1,0,1,"High deviation in NAT Destination Port, Destination Port, NAT Source Port"
50493,443,36062,443,allow,2147464,35144,2112320,1951,72,540,1411,1,"High deviation in pkts_sent, Bytes Received, Bytes"
52838,443,32099,443,allow,207289,9233,198056,234,136,83,151,1,"High deviation in pkts_sent, Bytes Received, Bytes"
49300,5228,46650,5228,allow,12589,6479,6110,172,4146,86,86,1,"High deviation in pkts_sent, Elapsed Time (sec), Bytes Sent"
53139,50285,41730,50285,allow,320,140,180,6,6,3,3,1,"High deviation in pkts_sent, NAT Destination Port, Destination Port"
50650,80,8138,80,allow,129929,6216,123713,164,21,74,90,1,"High deviation in pkts_sent, Bytes Received, Bytes"
57986,443,51773,443,allow,124014,6270,117744,175,27,69,106,1,"High deviation in pkts_sent, Bytes Received, Bytes"
38114,443,10061,443,allow,863998,37140,826858,1072,61,479,593,1,"High deviation in pkts_sent, Bytes Received, Bytes"
6881,63963,28408,63963,allow,207,118,89,2,1200,1,1,1,"High deviation in NAT Destination Port, Destination Port, Elapsed Time (sec)"
30188,17677,54608,17677,allow,11116,4642,6474,64,1457,30,34,1,"High deviation in pkts_sent, NAT Destination Port, Bytes Sent"
49593,5228,25502,5228,allow,9720,2717,7003,67,1019,34,33,1,"High deviation in pkts_sent, Bytes Sent, NAT Destination Port"
48736,443,16569,443,allow,371295,17988,353307,571,40,233,338,1,"High deviation in pkts_sent, Bytes Received, Bytes"
49429,443,22034,443,allow,990201,31101,959100,1061,192,383,678,1,"High deviation in pkts_sent, Bytes Received, Bytes"
49438,443,47897,443,allow,135574,9426,126148,201,183,102,99,1,"High deviation in pkts_sent, Bytes Received, Bytes"
49423,443,63927,443,allow,4287346,130607,4156739,4409,282,1473,2936,1,"High deviation in pkts_sent, Bytes Received, Bytes"
57470,56250,44821,56250,allow,330,330,0,6,1199,6,0,1,"High deviation in pkts_sent, NAT Destination Port, Destination Port"
37965,54777,17164,54777,allow,158,158,0,1,1200,1,0,1,"High deviation in NAT Destination Port, Destination Port, Elapsed Time (sec)"
51674,80,17494,80,allow,533166,22786,510380,905,50,321,584,1,"High deviation in pkts_sent, Bytes Received, Bytes"
53700,45682,9190,45682,allow,492,306,186,8,15,5,3,1,"High deviation in pkts_sent, NAT Destination Port, Destination Port"
50583,80,64336,80,allow,630930,27504,603426,812,74,381,431,1,"High deviation in pkts_sent, Bytes Received, Bytes"
60546,443,51628,443,allow,52666,33941,18725,95,139,49,46,1,"High deviation in pkts_sent, Bytes Sent, Bytes"
57470,51745,40205,51745,allow,3214,1260,1954,33,1371,17,16,1,"High deviation in pkts_sent, NAT Destination Port, Destination Port"
58056,443,56911,443,allow,866223,30135,836088,916,138,300,616,1,"High deviation in pkts_sent, Bytes Received, Bytes"
37965,32405,17637,32405,allow,766,248,518,4,1200,2,2,1,"High deviation in pkts_sent, NAT Destination Port, Destination Port"
50473,80,50473,80,allow,78355,11395,66960,122,27,62,60,1,"High deviation in pkts_sent, Bytes Received, Bytes"
51910,60443,64340,60443,allow,70,70,0,2,8,2,0,1,"High deviation in pkts_sent, NAT Destination Port, Destination Port"
38060,443,63699,443,allow,27679,15839,11840,75,103,39,36,1,"High deviation in pkts_sent, Bytes Sent, Bytes"
37965,16253,55858,16253,allow,5892,3784,2108,81,3115,47,34,1,"High deviation in pkts_sent, NAT Destination Port, Elapsed Time (sec)"
49436,443,51591,443,allow,784271,38715,745556,1017,183,465,552,1,"High deviation in pkts_sent, Bytes Received, Bytes"
58434,443,57588,443,allow,170342,10231,160111,264,136,130,134,1,"High deviation in pkts_sent, Bytes Received, Bytes"
49437,443,14429,443,allow,586175,29694,556481,753,182,349,404,1,"High deviation in pkts_sent, Bytes Received, Bytes"
47523,443,49117,443,allow,429929,11379,418550,456,21,174,282,1,"High deviation in pkts_sent, Bytes Received, Bytes"
49434,443,8627,443,allow,197635,12994,184641,287,183,143,144,1,"High deviation in pkts_sent, Bytes Received, Bytes"
56626,443,37778,443,allow,45304,28614,16690,82,41,45,37,1,"High deviation in pkts_sent, Bytes Sent, Bytes"
42384,443,3442,443,allow,101952,6925,95027,143,333,72,71,1,"High deviation in pkts_sent, Bytes Received, Bytes"
17750,39318,52655,39318,allow,481,150,331,2,1200,1,1,1,"High deviation in NAT Destination Port, Destination Port, Elapsed Time (sec)"
60440,53830,1700,53830,allow,320,140,180,6,6,3,3,1,"High deviation in pkts_sent, NAT Destination Port, Destination Port"
58843,80,20341,80,allow,1439485,27511,1411974,1308,108,369,939,1,"High deviation in pkts_sent, Bytes Received, Bytes"
56610,443,5877,443,allow,100002,5891,94111,138,44,60,78,1,"High deviation in pkts_sent, Bytes Received, Bytes"
37335,443,52361,443,allow,4734755,152171,4582584,5334,405,2083,3251,1,"High deviation in pkts_sent, Bytes Received, Bytes"
63130,55860,38620,55860,allow,1426,964,462,7,15,4,3,1,"High deviation in pkts_sent, NAT Destination Port, Destination Port"
6881,34635,39166,34635,allow,228,118,110,2,1200,1,1,1,"High deviation in NAT Destination Port, Destination Port, Elapsed Time (sec)"
37387,443,27821,443,allow,64440,16508,47932,101,142,44,57,1,"High deviation in pkts_sent, Bytes Sent, Bytes"
57470,60080,37928,60080,allow,12668,8506,4162,117,3745,74,43,1,"High deviation in pkts_sent, NAT Destination Port, Bytes Sent"
60864,5223,21557,5223,allow,6278,2408,3870,27,3600,15,12,1,"High deviation in pkts_sent, Elapsed Time (sec), NAT Destination Port"
53720,50795,49301,50795,allow,320,140,180,6,7,3,3,1,"High deviation in pkts_sent, NAT Destination Port, Destination Port"
58369,443,52510,443,allow,12779517,343310,12436207,12837,162,4589,8248,1,"High deviation in pkts_sent, Bytes Received, Bytes"
49560,443,58104,443,allow,13516,6981,6535,61,2149,34,27,1,"High deviation in pkts_sent, Bytes Sent, Elapsed Time (sec)"
51905,65253,13795,65253,allow,70,70,0,2,8,2,0,1,"High deviation in pkts_sent, NAT Destination Port, Destination Port"
58373,443,64061,443,allow,78832,12408,66424,109,162,46,63,1,"High deviation in pkts_sent, Bytes Received, Bytes"
63891,51350,44570,51350,allow,312,132,180,6,7,3,3,1,"High deviation in pkts_sent, NAT Destination Port, Destination Port"
58452,5228,20449,5228,allow,2855,1780,1075,20,3600,10,10,1,"High deviation in pkts_sent, Elapsed Time (sec), NAT Destination Port"
30960,45732,62764,45732,allow,330,330,0,6,3610,6,0,1,"High deviation in pkts_sent, NAT Destination Port, Elapsed Time (sec)"
27005,27126,47087,27126,allow,636020,187240,448780,2701,104,1538,1163,1,"High deviation in pkts_sent, Bytes Sent, Bytes"
49890,443,3826,443,allow,6370237,150385,6219852,6047,138,1688,4359,1,"High deviation in pkts_sent, Bytes Received, Bytes"
41776,443,58103,443,allow,3196404,47816,3148588,2668,147,469,2199,1,"High deviation in pkts_sent, Bytes Received, Bytes"
59964,443,8853,443,allow,166170,5611,160559,189,16,78,111,1,"High deviation in pkts_sent, Bytes Received, Bytes"
5238,36298,39762,36298,allow,179518,128,179390,173,37,3,170,1,"High deviation in pkts_sent, Bytes Received, Bytes"
38678,443,20008,443,allow,380978,8857,372121,373,16,115,258,1,"High deviation in pkts_sent, Bytes Received, Bytes"
41775,443,57658,443,allow,7036547,93047,6943500,5816,186,995,4821,1,"High deviation in pkts_sent, Bytes Received, Bytes"
50265,31101,44674,31101,allow,150,150,0,1,1200,1,0,1,"High deviation in NAT Destination Port, Elapsed Time (sec), Destination Port"
65488,443,64323,443,allow,92286,4799,87487,107,16,43,64,1,"High deviation in pkts_sent, Bytes Received, Bytes"
34744,443,31137,443,allow,13175,2432,10743,52,3587,23,29,1,"High deviation in pkts_sent, Elapsed Time (sec), Bytes Received"
50265,18417,40558,18417,allow,7282,4118,3164,57,1696,35,22,1,"High deviation in pkts_sent, NAT Destination Port, Bytes Sent"
41779,443,29003,443,allow,618072,8505,609567,523,87,90,433,1,"High deviation in pkts_sent, Bytes Received, Bytes"
65487,443,56960,443,allow,413465,12290,401175,427,16,150,277,1,"High deviation in pkts_sent, Bytes Received, Bytes"
6882,51508,23505,51508,allow,238,118,120,2,1200,1,1,1,"High deviation in NAT Destination Port, Destination Port, Elapsed Time (sec)"
38679,443,29452,443,allow,484912,17317,467595,550,16,229,321,1,"High deviation in pkts_sent, Bytes Received, Bytes"
57810,80,62948,80,allow,104397,8436,95961,122,21,49,73,1,"High deviation in pkts_sent, Bytes Received, Bytes"
59697,80,58873,80,allow,5326946,116544,5210402,5175,111,1695,3480,1,"High deviation in pkts_sent, Bytes Received, Bytes"
50278,443,27147,443,allow,259911,11421,248490,336,92,144,192,1,"High deviation in pkts_sent, Bytes Received, Bytes"
6649,80,6649,80,allow,103631,2766,100865,110,39,38,72,1,"High deviation in pkts_sent, Bytes Received, Bytes"
38892,443,57044,443,allow,83444,15305,68139,121,148,51,70,1,"High deviation in pkts_sent, Bytes Received, Bytes"
51221,49683,21900,49683,allow,870,330,540,12,1316,6,6,1,"High deviation in pkts_sent, NAT Destination Port, Destination Port"
30960,45731,48545,45731,allow,330,330,0,6,3610,6,0,1,"High deviation in pkts_sent, NAT Destination Port, Elapsed Time (sec)"
30960,45730,17923,45730,allow,330,330,0,6,3610,6,0,1,"High deviation in pkts_sent, NAT Destination Port, Elapsed Time (sec)"
37549,443,18373,443,allow,203299,6930,196369,231,16,92,139,1,"High deviation in pkts_sent, Bytes Received, Bytes"
43222,443,24936,443,allow,2088188,38201,2049987,1829,84,404,1425,1,"High deviation in pkts_sent, Bytes Received, Bytes"
6973,80,6973,80,allow,132958,3923,129035,143,38,53,90,1,"High deviation in pkts_sent, Bytes Received, Bytes"
51843,45702,23719,45702,allow,1261,637,624,9,30,5,4,1,"High deviation in pkts_sent, NAT Destination Port, Destination Port"
49755,443,49571,443,allow,447301,17016,430285,539,128,196,343,1,"High deviation in pkts_sent, Bytes Received, Bytes"
56496,80,21274,80,allow,458684,19849,438835,488,66,185,303,1,"High deviation in pkts_sent, Bytes Received, Bytes"
8662,80,8662,80,allow,194259,7011,187248,211,39,80,131,1,"High deviation in pkts_sent, Bytes Received, Bytes"
6932,80,6932,80,allow,124405,3747,120658,131,38,46,85,1,"High deviation in pkts_sent, Bytes Received, Bytes"
37965,51498,7708,51498,allow,158,158,0,1,1199,1,0,1,"High deviation in NAT Destination Port, Destination Port, Elapsed Time (sec)"
55877,53546,37144,53546,allow,481,150,331,2,1200,1,1,1,"High deviation in NAT Destination Port, Destination Port, Elapsed Time (sec)"
46155,443,27543,443,allow,206090,6478,199612,211,170,69,142,1,"High deviation in pkts_sent, Bytes Received, Bytes"
48733,443,64638,443,allow,316457,19287,297170,382,80,157,225,1,"High deviation in pkts_sent, Bytes Received, Bytes"
7030,80,7030,80,allow,115811,3862,111949,123,38,44,79,1,"High deviation in pkts_sent, Bytes Received, Bytes"
60213,80,54393,80,allow,47483,13980,33503,69,151,35,34,1,"High deviation in pkts_sent, Bytes Sent, Bytes"
9291,80,9291,80,allow,208056,7568,200488,227,39,88,139,1,"High deviation in pkts_sent, Bytes Received, Bytes"
60794,443,17248,443,allow,796772,27151,769621,878,137,302,576,1,"High deviation in pkts_sent, Bytes Received, Bytes"
46337,443,56368,443,allow,10379011,159069,10219942,8727,252,1321,7406,1,"High deviation in pkts_sent, Bytes Received, Bytes"
37965,50321,10306,50321,allow,158,158,0,1,1199,1,0,1,"High deviation in NAT Destination Port, Destination Port, Elapsed Time (sec)"
50967,443,6506,443,allow,612314,25589,586725,676,127,234,442,1,"High deviation in pkts_sent, Bytes Received, Bytes"
37965,23215,60797,23215,allow,537,158,379,2,1199,1,1,1,"High deviation in NAT Destination Port, Elapsed Time (sec), Destination Port"
61191,443,24135,443,allow,569471,20976,548495,666,333,273,393,1,"High deviation in pkts_sent, Bytes Received, Bytes"
37965,51413,17500,51413,allow,848,252,596,4,1199,2,2,1,"High deviation in pkts_sent, NAT Destination Port, Destination Port"
51885,64546,12386,64546,allow,66,66,0,1,5,1,0,1,"High deviation in NAT Destination Port, Destination Port, Bytes"
51840,80,51840,80,allow,525257,17273,507984,531,26,183,348,1,"High deviation in pkts_sent, Bytes Received, Bytes"
51839,80,51839,80,allow,951054,20747,930307,902,26,276,626,1,"High deviation in pkts_sent, Bytes Received, Bytes"
58370,443,50234,443,allow,6277528,124223,6153305,5970,160,1890,4080,1,"High deviation in pkts_sent, Bytes Received, Bytes"
51221,63128,42268,63128,allow,480,149,331,2,1201,1,1,1,"High deviation in NAT Destination Port, Destination Port, Elapsed Time (sec)"
49160,50321,21626,50321,allow,150,150,0,2,1200,2,0,1,"High deviation in pkts_sent, NAT Destination Port, Destination Port"
15503,42286,2173,42286,allow,480,149,331,2,1200,1,1,1,"High deviation in NAT Destination Port, Destination Port, Elapsed Time (sec)"
44884,443,19838,443,allow,36435,28844,7591,65,396,35,30,1,"High deviation in pkts_sent, Bytes Sent, Bytes"
36531,443,53488,443,allow,123782,10685,113097,157,180,65,92,1,"High deviation in pkts_sent, Bytes Received, Bytes"
53248,443,60652,443,allow,532222,22112,510110,645,232,259,386,1,"High deviation in pkts_sent, Bytes Received, Bytes"
43220,443,18756,443,allow,3178535,62767,3115768,2800,83,626,2174,1,"High deviation in pkts_sent, Bytes Received, Bytes"
51907,47518,40645,47518,allow,316,136,180,6,5,3,3,1,"High deviation in pkts_sent, NAT Destination Port, Destination Port"
51965,80,35850,80,allow,106904,5958,100946,139,66,62,77,1,"High deviation in pkts_sent, Bytes Received, Bytes"
49947,80,44031,80,allow,362232,10443,351789,387,15,147,240,1,"High deviation in pkts_sent, Bytes Received, Bytes"
59834,80,63639,80,allow,943291,17238,926053,869,72,249,620,1,"High deviation in pkts_sent, Bytes Received, Bytes"
57007,5333,59200,5333,allow,7194101,1949033,5245068,50585,1008,24913,25672,1,"High deviation in pkts_sent, Bytes Sent, Bytes"
42595,443,30091,443,allow,190565,9979,180586,272,244,140,132,1,"High deviation in pkts_sent, Bytes Received, Bytes"
53249,443,17659,443,allow,3292049,87705,3204344,3470,232,1188,2282,1,"High deviation in pkts_sent, Bytes Received, Bytes"
51842,80,51842,80,allow,407760,15074,392686,424,25,154,270,1,"High deviation in pkts_sent, Bytes Received, Bytes"
49183,443,49342,443,allow,473744,13158,460586,495,20,183,312,1,"High deviation in pkts_sent, Bytes Received, Bytes"
47828,443,4397,443,allow,512466,48982,463484,912,124,446,466,1,"High deviation in pkts_sent, Bytes Received, Bytes"
34746,443,4348,443,allow,284320,14149,270171,398,244,203,195,1,"High deviation in pkts_sent, Bytes Received, Bytes"
49573,443,42644,443,allow,111881,6152,105729,137,139,51,86,1,"High deviation in pkts_sent, Bytes Received, Bytes"
6881,48608,12608,48608,allow,228,118,110,2,1199,1,1,1,"High deviation in NAT Destination Port, Destination Port, Elapsed Time (sec)"
56855,64607,58491,64607,allow,316,136,180,6,6,3,3,1,"High deviation in pkts_sent, NAT Destination Port, Destination Port"
64087,443,64087,443,allow,150808,48110,102698,173,173,82,91,1,"High deviation in pkts_sent, Bytes Sent, Bytes"
30188,15370,58525,15370,allow,10190,4774,5416,64,1490,32,32,1,"High deviation in pkts_sent, NAT Destination Port, Bytes Sent"
30960,45722,27416,45722,allow,396,396,0,7,3616,7,0,1,"High deviation in pkts_sent, NAT Destination Port, Elapsed Time (sec)"
6881,49001,20436,49001,allow,210,111,99,2,1201,1,1,1,"High deviation in NAT Destination Port, Destination Port, Elapsed Time (sec)"
30960,45727,32973,45727,allow,330,330,0,6,3610,6,0,1,"High deviation in pkts_sent, NAT Destination Port, Elapsed Time (sec)"
59675,80,26404,80,allow,3437462,77916,3359546,3384,134,1140,2244,1,"High deviation in pkts_sent, Bytes Received, Bytes"
57241,443,46273,443,allow,1167125,49170,1117955,1459,92,635,824,1,"High deviation in pkts_sent, Bytes Received, Bytes"
53145,27067,38874,27067,allow,1231702,397859,833843,10382,185,4780,5602,1,"High deviation in pkts_sent, Bytes Sent, Bytes"
64086,443,64086,443,allow,79107,10743,68364,96,172,42,54,1,"High deviation in pkts_sent, Bytes Received, Bytes"
58865,443,1630,443,allow,505070,16437,488633,543,45,187,356,1,"High deviation in pkts_sent, Bytes Received, Bytes"
53690,42301,12821,42301,allow,1821,1088,733,17,15,9,8,1,"High deviation in pkts_sent, NAT Destination Port, Destination Port"
38673,443,39946,443,allow,379440,8281,371159,362,16,106,256,1,"High deviation in pkts_sent, Bytes Received, Bytes"
60901,443,55846,443,allow,622058,33681,588377,765,65,327,438,1,"High deviation in pkts_sent, Bytes Received, Bytes"
59840,80,40850,80,allow,469946,11862,458084,482,68,173,309,1,"High deviation in pkts_sent, Bytes Received, Bytes"
50803,443,13145,443,allow,98472,44922,53550,491,658,181,310,1,"High deviation in pkts_sent, Bytes Sent, Bytes"
63068,443,30672,443,allow,2928239,68426,2859813,2888,37,955,1933,1,"High deviation in pkts_sent, Bytes Received, Bytes"
58862,443,37549,443,allow,1068717,27931,1040786,1093,45,351,742,1,"High deviation in pkts_sent, Bytes Received, Bytes"
58864,443,26989,443,allow,312852,8845,304007,317,45,99,218,1,"High deviation in pkts_sent, Bytes Received, Bytes"
55625,80,27507,80,allow,389326,9849,379477,391,21,138,253,1,"High deviation in pkts_sent, Bytes Received, Bytes"
53706,59208,33732,59208,allow,258,70,188,4,8,2,2,1,"High deviation in pkts_sent, NAT Destination Port, Destination Port"
45052,443,37093,443,allow,131573,4926,126647,152,152,55,97,1,"High deviation in pkts_sent, Bytes Received, Bytes"
60432,54312,22904,54312,allow,701,455,246,8,15,4,4,1,"High deviation in pkts_sent, NAT Destination Port, Destination Port"
60902,443,20935,443,allow,924886,40519,884367,1075,65,442,633,1,"High deviation in pkts_sent, Bytes Received, Bytes"
48480,443,23315,443,allow,10409,2670,7739,94,5805,17,77,1,"High deviation in pkts_sent, Elapsed Time (sec), Bytes Sent"
43224,443,58496,443,allow,2027060,31188,1995872,1708,77,321,1387,1,"High deviation in pkts_sent, Bytes Received, Bytes"
10151,54168,22661,54168,allow,479,150,329,2,1200,1,1,1,"High deviation in NAT Destination Port, Destination Port, Elapsed Time (sec)"
50802,443,32989,443,allow,207859,77557,130302,849,753,312,537,1,"High deviation in pkts_sent, Bytes Sent, Bytes"
57470,20433,47061,20433,allow,726,726,0,12,1200,12,0,1,"High deviation in pkts_sent, NAT Destination Port, Elapsed Time (sec)"
57470,59208,35897,59208,allow,1367,664,703,16,1199,9,7,1,"High deviation in pkts_sent, NAT Destination Port, Destination Port"
56260,80,50522,80,allow,72600,58760,13840,186,1232,107,79,1,"High deviation in pkts_sent, Bytes Sent, Bytes"
56745,443,56745,443,allow,101899,20048,81851,132,62,67,65,1,"High deviation in pkts_sent, Bytes Received, Bytes"
10047,443,65295,443,allow,25316,10344,14972,84,170,48,36,1,"High deviation in pkts_sent, Bytes Sent, Bytes"
55655,63670,23563,63670,allow,70,70,0,2,8,2,0,1,"High deviation in pkts_sent, NAT Destination Port, Destination Port"
57308,443,38390,443,allow,36373,15248,21125,172,123,69,103,1,"High deviation in pkts_sent, Bytes Sent, Bytes"
11295,40002,5818,40002,allow,356,170,186,6,53,3,3,1,"High deviation in pkts_sent, NAT Destination Port, Destination Port"
48909,5228,27859,5228,allow,11007,2491,8516,44,4411,18,26,1,"High deviation in pkts_sent, Elapsed Time (sec), Bytes Received"
59728,80,65227,80,allow,821011,16040,804971,778,100,238,540,1,"High deviation in pkts_sent, Bytes Received, Bytes"
53712,44822,45976,44822,allow,320,140,180,6,5,3,3,1,"High deviation in pkts_sent, NAT Destination Port, Destination Port"
63868,60392,13062,60392,allow,70,70,0,1,4,1,0,1,"High deviation in NAT Destination Port, Destination Port, Source Port"
38670,443,55536,443,allow,501559,13849,487710,527,15,193,334,1,"High deviation in pkts_sent, Bytes Received, Bytes"
56497,80,9145,80,allow,410119,16112,394007,424,63,155,269,1,"High deviation in pkts_sent, Bytes Received, Bytes"
56499,80,63072,80,allow,277848,13775,264073,301,63,118,183,1,"High deviation in pkts_sent, Bytes Received, Bytes"
56734,443,56734,443,allow,373876,52153,321723,424,87,185,239,1,"High deviation in pkts_sent, Bytes Received, Bytes"
56500,80,50985,80,allow,177736,11174,166562,198,63,77,121,1,"High deviation in pkts_sent, Bytes Received, Bytes"
56498,80,33330,80,allow,174021,11443,162578,197,63,81,116,1,"High deviation in pkts_sent, Bytes Received, Bytes"
50232,28356,48349,28356,allow,4728691,2246710,2481981,40252,1121,19716,20536,1,"High deviation in pkts_sent, Bytes Sent, Bytes"
51902,55933,35723,55933,allow,316,136,180,6,5,3,3,1,"High deviation in pkts_sent, NAT Destination Port, Destination Port"
53623,50093,42211,50093,allow,552,306,246,9,38,5,4,1,"High deviation in pkts_sent, NAT Destination Port, Destination Port"
56501,80,5186,80,allow,300370,14101,286269,313,63,116,197,1,"High deviation in pkts_sent, Bytes Received, Bytes"
51893,63924,11081,63924,allow,70,70,0,2,8,2,0,1,"High deviation in pkts_sent, NAT Destination Port, Destination Port"
51897,57057,49158,57057,allow,70,70,0,2,8,2,0,1,"High deviation in pkts_sent, NAT Destination Port, Destination Port"
38667,443,44334,443,allow,496852,12216,484636,499,16,167,332,1,"High deviation in pkts_sent, Bytes Received, Bytes"
53504,443,31592,443,allow,2291912,60511,2231401,2353,196,863,1490,1,"High deviation in pkts_sent, Bytes Received, Bytes"
52501,443,44230,443,allow,163226,10147,153079,233,101,101,132,1,"High deviation in pkts_sent, Bytes Received, Bytes"
59851,80,45085,80,allow,307815,6418,301397,285,63,84,201,1,"High deviation in pkts_sent, Bytes Received, Bytes"
53131,44021,31517,44021,allow,698,320,378,10,16,6,4,1,"High deviation in pkts_sent, NAT Destination Port, Destination Port"
39716,443,56404,443,allow,131171,10346,120825,183,150,93,90,1,"High deviation in pkts_sent, Bytes Received, Bytes"
55000,5222,35744,5222,allow,32608,22014,10594,225,215,124,101,1,"High deviation in pkts_sent, Bytes Sent, Bytes"
30188,32873,43392,32873,allow,502,150,352,2,1200,1,1,1,"High deviation in NAT Destination Port, Destination Port, Elapsed Time (sec)"
59772,443,48331,443,allow,181413,11493,169920,167,85,41,126,1,"High deviation in pkts_sent, Bytes Received, Bytes"
44858,5228,3088,5228,allow,6819,1586,5233,18,3603,9,9,1,"High deviation in pkts_sent, Elapsed Time (sec), NAT Destination Port"
52312,443,50036,443,allow,1574859,55851,1519008,1758,185,656,1102,1,"High deviation in pkts_sent, Bytes Received, Bytes"
65486,443,40088,443,allow,375786,11380,364406,388,16,137,251,1,"High deviation in pkts_sent, Bytes Received, Bytes"
65485,443,65115,443,allow,92447,4519,87928,105,16,39,66,1,"High deviation in pkts_sent, Bytes Received, Bytes"
50467,80,50467,80,allow,886702,38812,847890,1134,23,558,576,1,"High deviation in pkts_sent, Bytes Received, Bytes"
39612,443,50624,443,allow,482030,16677,465353,539,28,207,332,1,"High deviation in pkts_sent, Bytes Received, Bytes"
64298,443,45877,443,allow,115035,5282,109753,128,120,44,84,1,"High deviation in pkts_sent, Bytes Received, Bytes"
56524,443,14904,443,allow,344632,9074,335558,354,121,122,232,1,"High deviation in pkts_sent, Bytes Received, Bytes"
57470,58125,57009,58125,allow,1572,664,908,14,1200,9,5,1,"High deviation in pkts_sent, NAT Destination Port, Destination Port"
54121,443,19391,443,allow,26357358,863775,25493583,27347,208,8650,18697,1,"High deviation in pkts_sent, Bytes Received, Bytes"
53676,80,62250,80,allow,154478,6934,147544,194,24,86,108,1,"High deviation in pkts_sent, Bytes Received, Bytes"
50468,80,50468,80,allow,90393,7684,82709,132,22,69,63,1,"High deviation in pkts_sent, Bytes Received, Bytes"
53253,443,34431,443,allow,36393,27741,8652,147,210,76,71,1,"High deviation in pkts_sent, Bytes Sent, Bytes"
50466,80,50466,80,allow,78335,7114,71221,114,22,60,54,1,"High deviation in pkts_sent, Bytes Received, Bytes"
49292,443,18411,443,allow,80199,66182,14017,134,163,87,47,1,"High deviation in pkts_sent, Bytes Sent, Bytes"
47196,443,63403,443,allow,2701330,44089,2657241,2230,134,296,1934,1,"High deviation in pkts_sent, Bytes Received, Bytes"
57470,47099,22688,47099,allow,330,330,0,6,1199,6,0,1,"High deviation in pkts_sent, NAT Destination Port, Destination Port"
53232,443,62934,443,allow,102629,3555,99074,114,58,40,74,1,"High deviation in pkts_sent, Bytes Received, Bytes"
53212,443,62292,443,allow,81114,4708,76406,108,66,39,69,1,"High deviation in pkts_sent, Bytes Received, Bytes"
49944,80,49944,80,allow,220279,13007,207272,266,22,115,151,1,"High deviation in pkts_sent, Bytes Received, Bytes"
49941,80,49941,80,allow,493003,23995,469008,578,22,246,332,1,"High deviation in pkts_sent, Bytes Received, Bytes"
62464,41090,36975,41090,allow,454923,271912,183011,516,549,295,221,1,"High deviation in pkts_sent, Bytes Sent, Bytes"
49943,80,49943,80,allow,254742,14106,240636,305,22,131,174,1,"High deviation in pkts_sent, Bytes Received, Bytes"
49942,80,49942,80,allow,323714,18296,305418,384,22,165,219,1,"High deviation in pkts_sent, Bytes Received, Bytes"
50463,80,50463,80,allow,210639,12949,197690,287,23,147,140,1,"High deviation in pkts_sent, Bytes Received, Bytes"
17750,25326,52113,25326,allow,491,150,341,2,1200,1,1,1,"High deviation in NAT Destination Port, Elapsed Time (sec), Destination Port"
49218,5222,44351,5222,allow,85080,31769,53311,661,1172,305,356,1,"High deviation in pkts_sent, Bytes Sent, Bytes"
50464,80,50464,80,allow,218570,13559,205011,291,22,146,145,1,"High deviation in pkts_sent, Bytes Received, Bytes"
50465,80,50465,80,allow,202622,12371,190251,264,22,132,132,1,"High deviation in pkts_sent, Bytes Received, Bytes"
59837,80,33837,80,allow,830733,17622,813111,789,66,245,544,1,"High deviation in pkts_sent, Bytes Received, Bytes"
53229,443,57933,443,allow,91414,11700,79714,174,59,65,109,1,"High deviation in pkts_sent, Bytes Received, Bytes"
53218,443,1969,443,allow,245772,8639,237133,291,66,103,188,1,"High deviation in pkts_sent, Bytes Received, Bytes"
25,63566,25,63566,allow,102,102,0,1,5,1,0,1,"High deviation in NAT Destination Port, Destination Port, Source Port"
59166,443,40050,443,allow,130458,7920,122538,199,359,94,105,1,"High deviation in pkts_sent, Bytes Received, Bytes"
9067,443,32087,443,allow,11768028,275478,11492550,12305,77,4158,8147,1,"High deviation in pkts_sent, Bytes Received, Bytes"
9055,443,33529,443,allow,6594797,175738,6419059,6398,123,1755,4643,1,"High deviation in pkts_sent, Bytes Received, Bytes"
57470,41024,3847,41024,allow,330,330,0,6,1200,6,0,1,"High deviation in pkts_sent, NAT Destination Port, Destination Port"
55172,80,55172,80,allow,268230,8528,259702,292,231,106,186,1,"High deviation in pkts_sent, Bytes Received, Bytes"
57470,58973,26085,58973,allow,330,330,0,6,1200,6,0,1,"High deviation in pkts_sent, NAT Destination Port, Destination Port"
51209,443,64337,443,allow,84768,21103,63665,136,133,58,78,1,"High deviation in pkts_sent, Bytes Sent, Bytes"
64335,443,56064,443,allow,230615,48569,182046,379,176,157,222,1,"High deviation in pkts_sent, Bytes Received, Bytes"
57470,24260,9692,24260,allow,806,163,643,2,1201,1,1,1,"High deviation in NAT Destination Port, Elapsed Time (sec), Destination Port"
50083,80,45276,80,allow,38045,26409,11636,105,476,68,37,1,"High deviation in pkts_sent, Bytes Sent, Bytes"
59744,80,14710,80,allow,699554,16426,683128,701,95,244,457,1,"High deviation in pkts_sent, Bytes Received, Bytes"
56850,64932,41419,64932,allow,70,70,0,1,5,1,0,1,"High deviation in NAT Destination Port, Destination Port, NAT Source Port"
41945,443,44467,443,allow,12146,2681,9465,63,4156,25,38,1,"High deviation in pkts_sent, Elapsed Time (sec), Bytes Received"
34739,5222,35050,5222,allow,26914,4119,22795,85,539,41,44,1,"High deviation in pkts_sent, Bytes Received, Bytes"
49708,80,56764,80,allow,179277,5324,173953,171,108,49,122,1,"High deviation in pkts_sent, Bytes Received, Bytes"
49707,80,15833,80,allow,196092,6387,189705,189,108,57,132,1,"High deviation in pkts_sent, Bytes Received, Bytes"
49704,80,31664,80,allow,217502,6597,210905,211,109,62,149,1,"High deviation in pkts_sent, Bytes Received, Bytes"
43346,443,33396,443,allow,3691281,56325,3634956,3201,138,570,2631,1,"High deviation in pkts_sent, Bytes Received, Bytes"
49705,80,59166,80,allow,132198,5466,126732,140,109,45,95,1,"High deviation in pkts_sent, Bytes Received, Bytes"
57470,32251,57534,32251,allow,132,132,0,3,1199,3,0,1,"High deviation in pkts_sent, NAT Destination Port, Destination Port"
51712,443,2406,443,allow,66148,6145,60003,116,80,60,56,1,"High deviation in pkts_sent, Bytes Received, Bytes"
50265,37449,54760,37449,allow,925,594,331,11,2335,10,1,1,"High deviation in pkts_sent, NAT Destination Port, Elapsed Time (sec)"
49709,80,35500,80,allow,128214,4961,123253,134,108,43,91,1,"High deviation in pkts_sent, Bytes Received, Bytes"
49706,80,39061,80,allow,118813,4128,114685,122,108,38,84,1,"High deviation in pkts_sent, Bytes Received, Bytes"
53895,443,14973,443,allow,390740,13639,377101,441,132,152,289,1,"High deviation in pkts_sent, Bytes Received, Bytes"
6881,45711,37473,45711,allow,228,118,110,2,1199,1,1,1,"High deviation in NAT Destination Port, Destination Port, Elapsed Time (sec)"
49160,38552,12049,38552,allow,868,150,718,4,1200,2,2,1,"High deviation in pkts_sent, NAT Destination Port, Destination Port"
41891,443,2286,443,allow,235626,4546,231080,232,339,53,179,1,"High deviation in pkts_sent, Bytes Received, Bytes"
53233,443,40528,443,allow,47830,23388,24442,74,51,37,37,1,"High deviation in pkts_sent, Bytes Sent, Bytes"
5237,30128,2836,30128,allow,621281,256,621025,881,49,5,876,1,"High deviation in pkts_sent, Bytes Received, Bytes"
51885,64546,64002,64546,allow,70,70,0,2,8,2,0,1,"High deviation in pkts_sent, NAT Destination Port, Destination Port"
38611,443,14308,443,allow,22215289,662818,21552471,25924,349,8862,17062,1,"High deviation in pkts_sent, Bytes Received, Bytes"
56210,5228,6603,5228,allow,7061,1730,5331,21,3600,11,10,1,"High deviation in pkts_sent, Elapsed Time (sec), NAT Destination Port"
50265,45682,46008,45682,allow,402,132,270,6,1209,3,3,1,"High deviation in pkts_sent, NAT Destination Port, Destination Port"
64085,443,64085,443,allow,140818,8751,132067,156,168,57,99,1,"High deviation in pkts_sent, Bytes Received, Bytes"
59275,443,56019,443,allow,242735602,5306961,237428641,238334,3604,81340,156994,1,"High deviation in pkts_sent, Bytes Received, Bytes"
55760,443,60909,443,allow,12723734,404530,12319204,13539,134,4494,9045,1,"High deviation in pkts_sent, Bytes Received, Bytes"
54437,80,15743,80,allow,95298,61941,33357,182,929,95,87,1,"High deviation in pkts_sent, Bytes Sent, Bytes"
63847,45598,22596,45598,allow,376,254,122,6,15,4,2,1,"High deviation in pkts_sent, NAT Destination Port, Destination Port"
33564,443,54838,443,allow,314376,14130,300246,399,246,169,230,1,"High deviation in pkts_sent, Bytes Received, Bytes"
40980,443,52078,443,allow,567854,22650,545204,713,158,311,402,1,"High deviation in pkts_sent, Bytes Received, Bytes"
50394,443,24134,443,allow,60424,4482,55942,101,686,39,62,1,"High deviation in pkts_sent, Bytes Received, Bytes"
49205,443,49232,443,allow,512444,20822,491622,555,159,191,364,1,"High deviation in pkts_sent, Bytes Received, Bytes"
49903,443,11070,443,allow,355761,14847,340914,423,33,183,240,1,"High deviation in pkts_sent, Bytes Received, Bytes"
6881,13929,23344,13929,allow,502,150,352,2,1200,1,1,1,"High deviation in NAT Destination Port, Elapsed Time (sec), Destination Port"
6881,25243,30519,25243,allow,498,150,348,4,1273,2,2,1,"High deviation in pkts_sent, NAT Destination Port, Elapsed Time (sec)"
54970,443,62898,443,allow,251620,16028,235592,353,371,159,194,1,"High deviation in pkts_sent, Bytes Received, Bytes"
6881,31026,35308,31026,allow,509,150,359,2,1199,1,1,1,"High deviation in NAT Destination Port, Elapsed Time (sec), Destination Port"
37965,39108,36972,39108,allow,1056,1056,0,17,1550,17,0,1,"High deviation in pkts_sent, NAT Destination Port, Elapsed Time (sec)"
57470,6969,61511,6969,allow,37677,7875,29802,115,3342,58,57,1,"High deviation in pkts_sent, Bytes Received, Bytes"
30960,45724,8617,45724,allow,330,330,0,6,3609,6,0,1,"High deviation in pkts_sent, NAT Destination Port, Elapsed Time (sec)"
42601,443,30864,443,allow,10845900,123386,10722514,8862,139,1081,7781,1,"High deviation in pkts_sent, Bytes Received, Bytes"
57470,41813,46944,41813,allow,519,166,353,2,1200,1,1,1,"High deviation in NAT Destination Port, Destination Port, Elapsed Time (sec)"
15503,48319,24114,48319,allow,481,150,331,2,1199,1,1,1,"High deviation in NAT Destination Port, Destination Port, Elapsed Time (sec)"
57470,18634,6347,18634,allow,594,594,0,10,1199,10,0,1,"High deviation in pkts_sent, NAT Destination Port, Elapsed Time (sec)"
49743,443,63725,443,allow,157156,3872,153284,160,128,48,112,1,"High deviation in pkts_sent, Bytes Received, Bytes"
62732,443,28854,443,allow,50000,36438,13562,98,336,61,37,1,"High deviation in pkts_sent, Bytes Sent, Bytes"
54926,6789,33904,6789,allow,124239,48650,75589,1342,84,628,714,1,"High deviation in pkts_sent, Bytes Sent, Packets"
41321,443,40754,443,allow,6989232,188564,6800668,7110,288,2412,4698,1,"High deviation in pkts_sent, Bytes Received, Bytes"
41133,443,38649,443,allow,6964782,246690,6718092,7203,184,2494,4709,1,"High deviation in pkts_sent, Bytes Received, Bytes"
60425,60425,17270,60425,allow,1728,1031,697,14,17,8,6,1,"High deviation in pkts_sent, NAT Destination Port, Destination Port"
50999,443,48896,443,allow,33716,17750,15966,134,329,72,62,1,"High deviation in pkts_sent, Bytes Sent, Bytes"
6881,35045,1586,35045,allow,475,150,325,2,1200,1,1,1,"High deviation in NAT Destination Port, Destination Port, Elapsed Time (sec)"
56707,443,58509,443,allow,40263,17490,22773,75,403,35,40,1,"High deviation in pkts_sent, Bytes Sent, Bytes"
15503,7750,61935,7750,allow,858,858,0,14,1200,14,0,1,"High deviation in pkts_sent, NAT Destination Port, Elapsed Time (sec)"
8979,443,54799,443,allow,62149740,2002795,60146945,62894,211,19380,43514,1,"High deviation in pkts_sent, Bytes Received, Bytes"
53666,50321,61664,50321,allow,736,490,246,8,17,4,4,1,"High deviation in pkts_sent, NAT Destination Port, Destination Port"
9073,443,37513,443,allow,4187235,99258,4087977,4375,28,1464,2911,1,"High deviation in pkts_sent, Bytes Received, Bytes"
11319,443,11319,443,allow,179461,16904,162557,220,36,105,115,1,"High deviation in pkts_sent, Bytes Received, Bytes"
30960,45723,17261,45723,allow,330,330,0,6,3608,6,0,1,"High deviation in pkts_sent, NAT Destination Port, Elapsed Time (sec)"
53508,80,33768,80,allow,16965052,382638,16582414,16619,61,5458,11161,1,"High deviation in pkts_sent, Bytes Received, Bytes"
57636,80,57636,80,allow,147506,3521,143985,125,32,23,102,1,"High deviation in pkts_sent, Bytes Received, Bytes"
32899,443,18208,443,allow,47948,40338,7610,82,17,43,39,1,"High deviation in pkts_sent, Bytes Sent, Bytes"
57642,80,57642,80,allow,220515,3488,217027,180,31,31,149,1,"High deviation in pkts_sent, Bytes Received, Bytes"
38433,443,38484,443,allow,33344,25806,7538,105,130,56,49,1,"High deviation in pkts_sent, Bytes Sent, Bytes"
50265,50262,19967,50262,allow,3758,2456,1302,52,2355,31,21,1,"High deviation in pkts_sent, NAT Destination Port, Elapsed Time (sec)"
51221,55497,56542,55497,allow,528,528,0,9,1200,9,0,1,"High deviation in pkts_sent, NAT Destination Port, Destination Port"
57470,50321,46751,50321,allow,538,166,372,2,1199,1,1,1,"High deviation in NAT Destination Port, Destination Port, Elapsed Time (sec)"
60973,443,19022,443,allow,398300,18473,379827,492,72,222,270,1,"High deviation in pkts_sent, Bytes Received, Bytes"
60977,443,59690,443,allow,275026,15030,259996,353,72,167,186,1,"High deviation in pkts_sent, Bytes Received, Bytes"
41547,80,41547,80,allow,120443,1965,118478,108,20,21,87,1,"High deviation in pkts_sent, Bytes Received, Bytes"
51221,15886,64989,15886,allow,481,150,331,2,1200,1,1,1,"High deviation in NAT Destination Port, Elapsed Time (sec), Destination Port"
37923,443,39242,443,allow,2593394,70243,2523151,2678,303,908,1770,1,"High deviation in pkts_sent, Bytes Received, Bytes"
51221,55497,24312,55497,allow,330,330,0,6,1200,6,0,1,"High deviation in pkts_sent, NAT Destination Port, Destination Port"
65483,443,48950,443,allow,92479,4869,87610,109,16,44,65,1,"High deviation in pkts_sent, Bytes Received, Bytes"
10151,60419,62503,60419,allow,479,150,329,2,1200,1,1,1,"High deviation in NAT Destination Port, Destination Port, Elapsed Time (sec)"
60974,443,22731,443,allow,166465,9498,156967,220,72,100,120,1,"High deviation in pkts_sent, Bytes Received, Bytes"
60975,443,27000,443,allow,333131,17461,315670,435,72,211,224,1,"High deviation in pkts_sent, Bytes Received, Bytes"
63868,60392,39941,60392,allow,66,66,0,2,7,2,0,1,"High deviation in pkts_sent, NAT Destination Port, Destination Port"
65484,443,29745,443,allow,148284,6200,142084,165,16,63,102,1,"High deviation in pkts_sent, Bytes Received, Bytes"
40931,443,31983,443,allow,7399,3328,4071,76,4153,33,43,1,"High deviation in pkts_sent, Elapsed Time (sec), Bytes Sent"
39105,443,21624,443,allow,2853588,73973,2779615,2907,129,994,1913,1,"High deviation in pkts_sent, Bytes Received, Bytes"
57097,443,3043,443,allow,3578432,133577,3444855,4291,426,1634,2657,1,"High deviation in pkts_sent, Bytes Received, Bytes"
50584,51413,31327,51413,allow,498,150,348,4,2396,2,2,1,"High deviation in pkts_sent, NAT Destination Port, Elapsed Time (sec)"
51221,62348,26234,62348,allow,132,132,0,3,1200,3,0,1,"High deviation in pkts_sent, NAT Destination Port, Destination Port"
64516,443,9177,443,allow,2649258,1156086,1493172,7283,5215,3384,3899,1,"High deviation in pkts_sent, Bytes Sent, Bytes"
6882,40796,60379,40796,allow,228,118,110,2,1200,1,1,1,"High deviation in NAT Destination Port, Destination Port, Elapsed Time (sec)"
57470,38871,35688,38871,allow,545,166,379,2,1199,1,1,1,"High deviation in NAT Destination Port, Destination Port, Elapsed Time (sec)"
57470,52177,52924,52177,allow,1980,1980,0,31,2321,31,0,1,"High deviation in pkts_sent, NAT Destination Port, Elapsed Time (sec)"
19473,12345,64156,12345,allow,478,149,329,2,1200,1,1,1,"High deviation in NAT Destination Port, Elapsed Time (sec), Destination Port"
48483,443,20913,443,allow,60944,9555,51389,71,362,25,46,1,"High deviation in pkts_sent, Bytes Received, Bytes"
58705,5228,47511,5228,allow,4706,2850,1856,44,6872,25,19,1,"High deviation in pkts_sent, Elapsed Time (sec), Bytes Sent"
57470,19641,64041,19641,allow,132,132,0,3,1199,3,0,1,"High deviation in pkts_sent, NAT Destination Port, Elapsed Time (sec)"
58183,443,49158,443,allow,841459,41656,799803,1083,141,389,694,1,"High deviation in pkts_sent, Bytes Received, Bytes"
60272,443,56856,443,allow,13199834,344312,12855522,13125,121,3739,9386,1,"High deviation in pkts_sent, Bytes Received, Bytes"
34366,443,52089,443,allow,520306,17622,502684,582,210,210,372,1,"High deviation in pkts_sent, Bytes Received, Bytes"
41316,443,15056,443,allow,4997074,153969,4843105,5249,343,1861,3388,1,"High deviation in pkts_sent, Bytes Received, Bytes"
37965,58909,50714,58909,allow,1577,594,983,20,1724,10,10,1,"High deviation in pkts_sent, NAT Destination Port, Destination Port"
56843,64277,53228,64277,allow,70,70,0,1,5,1,0,1,"High deviation in NAT Destination Port, Destination Port, NAT Source Port"
37835,443,55999,443,allow,63724,45783,17941,171,123,85,86,1,"High deviation in pkts_sent, Bytes Sent, Bytes"
56486,443,16895,443,allow,2673671,30446,2643225,2145,125,234,1911,1,"High deviation in pkts_sent, Bytes Received, Bytes"
26499,80,26499,80,allow,168957,11365,157592,202,31,90,112,1,"High deviation in pkts_sent, Bytes Received, Bytes"
26501,80,26501,80,allow,93644,8868,84776,131,31,64,67,1,"High deviation in pkts_sent, Bytes Received, Bytes"
26503,80,26503,80,allow,225609,13986,211623,285,31,134,151,1,"High deviation in pkts_sent, Bytes Received, Bytes"
26496,80,26496,80,allow,160989,10162,150827,189,31,81,108,1,"High deviation in pkts_sent, Bytes Received, Bytes"
56908,443,5972,443,allow,187104,26358,160746,205,190,58,147,1,"High deviation in pkts_sent, Bytes Received, Bytes"
57470,50321,43161,50321,allow,9414,7249,2165,91,3838,76,15,1,"High deviation in pkts_sent, NAT Destination Port, Bytes Sent"
50719,443,22608,443,allow,17803069,497380,17305689,17583,219,5899,11684,1,"High deviation in pkts_sent, Bytes Received, Bytes"
21133,54322,33050,54322,allow,480,149,331,2,1200,1,1,1,"High deviation in NAT Destination Port, Destination Port, Elapsed Time (sec)"
47058,443,44896,443,allow,328838,76878,251960,449,243,185,264,1,"High deviation in pkts_sent, Bytes, Bytes Sent"
53671,60416,30870,60416,allow,70,70,0,1,4,1,0,1,"High deviation in NAT Destination Port, Destination Port, NAT Source Port"
34373,28678,41304,28678,allow,1806,1806,0,22,224,22,0,1,"High deviation in pkts_sent, NAT Destination Port, Destination Port"
49180,443,17664,443,allow,888019,22655,865364,902,18,322,580,1,"High deviation in pkts_sent, Bytes Received, Bytes"
38121,443,50120,443,allow,1515436,54168,1461268,1689,16,687,1002,1,"High deviation in pkts_sent, Bytes Received, Bytes"
26502,80,26502,80,allow,184480,11115,173365,239,30,116,123,1,"High deviation in pkts_sent, Bytes Received, Bytes"
57054,80,1820,80,allow,25138,16043,9095,79,2410,53,26,1,"High deviation in pkts_sent, Bytes Sent, Bytes"
55641,61762,29914,61762,allow,70,70,0,1,5,1,0,1,"High deviation in NAT Destination Port, Destination Port, NAT Source Port"
37965,33622,23125,33622,allow,132,132,0,3,1199,3,0,1,"High deviation in pkts_sent, NAT Destination Port, Destination Port"
60427,61137,28150,61137,allow,70,70,0,1,5,1,0,1,"High deviation in NAT Destination Port, Destination Port, NAT Source Port"
59314,443,58564,443,allow,16862,7584,9278,97,8912,60,37,1,"High deviation in pkts_sent, Elapsed Time (sec), Bytes Sent"
53540,443,65354,443,allow,20948,4141,16807,76,616,37,39,1,"High deviation in pkts_sent, Bytes Received, Bytes"
55647,61042,18333,61042,allow,320,140,180,6,7,3,3,1,"High deviation in pkts_sent, NAT Destination Port, Destination Port"
35756,80,35756,80,allow,364170,17670,346500,412,31,170,242,1,"High deviation in pkts_sent, Bytes Received, Bytes"
22199,443,22199,443,allow,79787,12741,67046,117,31,65,52,1,"High deviation in pkts_sent, Bytes Received, Bytes"
54553,443,44028,443,allow,68345,58488,9857,122,329,62,60,1,"High deviation in pkts_sent, Bytes Sent, Bytes"
35753,80,35753,80,allow,158890,11318,147572,182,30,74,108,1,"High deviation in pkts_sent, Bytes Received, Bytes"
60374,80,60374,80,allow,118413,7486,110927,151,33,70,81,1,"High deviation in pkts_sent, Bytes Received, Bytes"
39915,443,44120,443,allow,6922156,117604,6804552,6122,50,1519,4603,1,"High deviation in pkts_sent, Bytes Received, Bytes"
35755,80,35755,80,allow,201552,13184,188368,245,30,111,134,1,"High deviation in pkts_sent, Bytes Received, Bytes"
35752,80,35752,80,allow,871846,24071,847775,900,30,326,574,1,"High deviation in pkts_sent, Bytes Received, Bytes"
51077,13021,36103,13021,allow,154976,25739,129237,605,387,321,284,1,"High deviation in pkts_sent, Bytes Received, Bytes"
50265,38203,29229,38203,allow,480,149,331,2,1200,1,1,1,"High deviation in NAT Destination Port, Destination Port, Elapsed Time (sec)"
60375,80,60375,80,allow,172473,8713,163760,205,33,91,114,1,"High deviation in pkts_sent, Bytes Received, Bytes"
35754,80,35754,80,allow,141193,10612,130581,165,30,69,96,1,"High deviation in pkts_sent, Bytes Received, Bytes"
58278,443,51446,443,allow,7349712,213635,7136077,7600,192,2303,5297,1,"High deviation in pkts_sent, Bytes Received, Bytes"
60376,80,60376,80,allow,180425,10839,169586,213,33,93,120,1,"High deviation in pkts_sent, Bytes Received, Bytes"
35751,80,35751,80,allow,336615,15190,321425,383,31,159,224,1,"High deviation in pkts_sent, Bytes Received, Bytes"
59743,80,42514,80,allow,815748,15896,799852,777,90,244,533,1,"High deviation in pkts_sent, Bytes Received, Bytes"
54961,443,58980,443,allow,1015861,30762,985099,1147,257,421,726,1,"High deviation in pkts_sent, Bytes Received, Bytes"
37941,443,61204,443,allow,69429,16478,52951,156,182,83,73,1,"High deviation in pkts_sent, Bytes Sent, Bytes"
51073,80,13586,80,allow,525373,237667,287706,1387,390,693,694,1,"High deviation in pkts_sent, Bytes Sent, Bytes"
51856,62841,45068,62841,allow,136,136,0,3,13,3,0,1,"High deviation in pkts_sent, NAT Destination Port, Destination Port"
60369,80,60369,80,allow,266818,12375,254443,285,34,107,178,1,"High deviation in pkts_sent, Bytes Received, Bytes"
57066,443,13444,443,allow,556770,88286,468484,777,202,314,463,1,"High deviation in pkts_sent, Bytes Received, Bytes"
57790,443,8937,443,allow,117653,21783,95870,251,556,93,158,1,"High deviation in pkts_sent, Bytes Received, Bytes"
59262,80,59262,80,allow,94514,14468,80046,152,15,41,111,1,"High deviation in pkts_sent, Bytes Received, Bytes"
6881,48533,62658,48533,allow,502,150,352,2,1199,1,1,1,"High deviation in NAT Destination Port, Destination Port, Elapsed Time (sec)"
57791,443,18201,443,allow,30057,13955,16102,146,556,65,81,1,"High deviation in pkts_sent, Bytes Sent, Bytes"
22983,443,22983,443,allow,205941,20753,185188,264,30,129,135,1,"High deviation in pkts_sent, Bytes Received, Bytes"
17750,12550,53024,12550,allow,491,150,341,2,1200,1,1,1,"High deviation in NAT Destination Port, Elapsed Time (sec), Destination Port"
48839,443,60350,443,allow,111590,17663,93927,212,115,93,119,1,"High deviation in pkts_sent, Bytes Received, Bytes"
61286,443,41653,443,allow,248071,7320,240751,269,268,89,180,1,"High deviation in pkts_sent, Bytes Received, Bytes"
49737,443,13001,443,allow,37094,22774,14320,125,27,72,53,1,"High deviation in pkts_sent, Bytes Sent, Bytes"
49651,443,6996,443,allow,920003,731041,188962,2024,929,1212,812,1,"High deviation in pkts_sent, Bytes Sent, Bytes"
49146,443,26817,443,allow,47589,17003,30586,283,238,128,155,1,"High deviation in pkts_sent, Bytes Sent, Bytes"
49718,443,50184,443,allow,7644833,215496,7429337,8664,135,2509,6155,1,"High deviation in pkts_sent, Bytes Received, Bytes"
59261,80,59261,80,allow,109128,4773,104355,197,15,68,129,1,"High deviation in pkts_sent, Bytes Received, Bytes"
49730,443,62541,443,allow,400810,14719,386091,506,39,164,342,1,"High deviation in pkts_sent, Bytes Received, Bytes"
37313,443,31778,443,allow,1364815,60410,1304405,1401,901,341,1060,1,"High deviation in pkts_sent, Bytes Received, Bytes"
60422,62456,45228,62456,allow,341,215,126,5,16,3,2,1,"High deviation in pkts_sent, NAT Destination Port, Destination Port"
55639,62954,47207,62954,allow,504,318,186,8,15,5,3,1,"High deviation in pkts_sent, NAT Destination Port, Destination Port"
45475,161,0,0,allow,41552,20621,20931,212,31,106,106,1,"High deviation in pkts_sent, Bytes Sent, Bytes"
6881,34746,2559,34746,allow,484,150,334,2,1200,1,1,1,"High deviation in NAT Destination Port, Destination Port, Elapsed Time (sec)"
47053,5228,30906,5228,allow,11647,2439,9208,47,3724,21,26,1,"High deviation in pkts_sent, Elapsed Time (sec), Bytes Received"
39108,443,16198,443,allow,330651,13398,317253,404,115,179,225,1,"High deviation in pkts_sent, Bytes Received, Bytes"
39094,443,50838,443,allow,828718,43410,785308,1071,347,479,592,1,"High deviation in pkts_sent, Bytes Received, Bytes"
49488,443,58643,443,allow,90030,13137,76893,92,47,29,63,1,"High deviation in pkts_sent, Bytes Received, Bytes"
61338,443,62752,443,allow,39067,7713,31354,74,247,29,45,1,"High deviation in pkts_sent, Bytes Received, Bytes"
61336,443,63223,443,allow,34919,6979,27940,68,247,27,41,1,"High deviation in pkts_sent, Bytes Received, Bytes"
52537,443,37723,443,allow,132577,21019,111558,348,236,142,206,1,"High deviation in pkts_sent, Bytes Received, Bytes"
50701,443,1473,443,allow,45394,5743,39651,133,233,49,84,1,"High deviation in pkts_sent, Bytes Received, Bytes"
5757,80,5757,80,allow,104444,4047,100397,122,126,52,70,1,"High deviation in pkts_sent, Bytes Received, Bytes"
42870,443,3034,443,allow,20248,1033,19215,28,3620,9,19,1,"High deviation in pkts_sent, Bytes Received, Elapsed Time (sec)"
39107,443,62182,443,allow,692830,23263,669567,784,114,306,478,1,"High deviation in pkts_sent, Bytes Received, Bytes"
62765,443,43288,443,allow,52223,3318,48905,75,321,30,45,1,"High deviation in pkts_sent, Bytes Received, Bytes"
39101,443,49967,443,allow,201217,15748,185469,327,207,163,164,1,"High deviation in pkts_sent, Bytes Received, Bytes"
57470,32348,51610,32348,allow,527,166,361,2,1199,1,1,1,"High deviation in NAT Destination Port, Destination Port, Elapsed Time (sec)"
65481,443,11803,443,allow,138507,5990,132517,156,16,60,96,1,"High deviation in pkts_sent, Bytes Received, Bytes"
51667,25826,12114,25826,allow,9434,9434,0,11,30,11,0,1,"High deviation in pkts_sent, NAT Destination Port, Bytes Sent"
57470,53756,4202,53756,allow,132,132,0,3,1199,3,0,1,"High deviation in pkts_sent, NAT Destination Port, Destination Port"
48817,51413,48817,51413,allow,460,150,310,2,1200,1,1,1,"High deviation in NAT Destination Port, Destination Port, Elapsed Time (sec)"
55877,38597,28809,38597,allow,481,150,331,2,1200,1,1,1,"High deviation in NAT Destination Port, Destination Port, Elapsed Time (sec)"
57470,23848,47855,23848,allow,545,166,379,2,1199,1,1,1,"High deviation in NAT Destination Port, Elapsed Time (sec), Destination Port"
36765,443,20693,443,allow,27557,20627,6930,89,5581,44,45,1,"High deviation in pkts_sent, Bytes Sent, Elapsed Time (sec)"
65482,443,24363,443,allow,92212,4799,87413,107,16,43,64,1,"High deviation in pkts_sent, Bytes Received, Bytes"
30188,41184,4045,41184,allow,509,150,359,2,1200,1,1,1,"High deviation in NAT Destination Port, Destination Port, Elapsed Time (sec)"
58369,443,14100,443,allow,155345,11568,143777,195,195,73,122,1,"High deviation in pkts_sent, Bytes Received, Bytes"
43435,5228,26335,5228,allow,6668,1369,5299,20,3600,10,10,1,"High deviation in pkts_sent, Elapsed Time (sec), NAT Destination Port"
59259,80,59259,80,allow,101244,15308,85936,165,15,53,112,1,"High deviation in pkts_sent, Bytes Received, Bytes"
64080,443,11837,443,allow,75064,64938,10126,147,277,71,76,1,"High deviation in pkts_sent, Bytes Sent, Bytes"
38436,5222,53562,5222,allow,7338,3611,3727,74,616,37,37,1,"High deviation in pkts_sent, Bytes Sent, NAT Destination Port"
57470,47191,13630,47191,allow,528,528,0,9,1200,9,0,1,"High deviation in pkts_sent, NAT Destination Port, Destination Port"
27005,27019,64712,27019,allow,1624,126,1498,4,31,2,2,1,"High deviation in pkts_sent, NAT Destination Port, Destination Port"
51221,51413,6783,51413,allow,459,149,310,2,1201,1,1,1,"High deviation in NAT Destination Port, Destination Port, Elapsed Time (sec)"
50127,80,7047,80,allow,164773,6196,158577,200,135,83,117,1,"High deviation in pkts_sent, Bytes Received, Bytes"
63785,55255,57684,55255,allow,3706,2125,1581,18,33,10,8,1,"High deviation in pkts_sent, NAT Destination Port, Destination Port"
43223,443,31934,443,allow,836939,25380,811559,864,64,302,562,1,"High deviation in pkts_sent, Bytes Received, Bytes"
57831,443,53060,443,allow,1320606,47731,1272875,1454,294,552,902,1,"High deviation in pkts_sent, Bytes Received, Bytes"
59258,80,59258,80,allow,107904,4143,103761,179,15,59,120,1,"High deviation in pkts_sent, Bytes Received, Bytes"
50118,443,10177,443,allow,125395,8711,116684,178,143,83,95,1,"High deviation in pkts_sent, Bytes Received, Bytes"
34531,443,54332,443,allow,135231,5033,130198,149,216,55,94,1,"High deviation in pkts_sent, Bytes Received, Bytes"
10060,443,49510,443,allow,293424,16379,277045,410,93,193,217,1,"High deviation in pkts_sent, Bytes Received, Bytes"
57827,443,29156,443,allow,912754,34972,877782,1035,294,410,625,1,"High deviation in pkts_sent, Bytes Received, Bytes"
15503,38120,41177,38120,allow,481,150,331,2,1200,1,1,1,"High deviation in NAT Destination Port, Destination Port, Elapsed Time (sec)"
57470,48622,44893,48622,allow,166,166,0,1,1200,1,0,1,"High deviation in NAT Destination Port, Destination Port, Elapsed Time (sec)"
53645,62348,1333,62348,allow,2395,1145,1250,13,16,6,7,1,"High deviation in pkts_sent, NAT Destination Port, Destination Port"
53656,58624,54901,58624,allow,70,70,0,1,5,1,0,1,"High deviation in NAT Destination Port, Destination Port, NAT Source Port"
50584,44816,28229,44816,allow,161,161,0,1,1201,1,0,1,"High deviation in NAT Destination Port, Destination Port, Elapsed Time (sec)"
50265,21544,58613,21544,allow,390,266,124,6,1200,4,2,1,"High deviation in pkts_sent, NAT Destination Port, Elapsed Time (sec)"
30960,45718,62760,45718,allow,330,330,0,6,3609,6,0,1,"High deviation in pkts_sent, NAT Destination Port, Elapsed Time (sec)"
53652,57503,44187,57503,allow,492,306,186,8,15,5,3,1,"High deviation in pkts_sent, NAT Destination Port, Destination Port"
8283,52443,24980,52443,allow,70,70,0,1,30,1,0,1,"High deviation in NAT Destination Port, Destination Port, Source Port"
10151,11809,51182,11809,allow,481,150,331,2,1200,1,1,1,"High deviation in NAT Destination Port, Elapsed Time (sec), Destination Port"
50265,37711,22022,37711,allow,132,132,0,3,1200,3,0,1,"High deviation in pkts_sent, NAT Destination Port, Destination Port"
6881,55085,23823,55085,allow,509,150,359,2,1199,1,1,1,"High deviation in NAT Destination Port, Destination Port, Elapsed Time (sec)"
57470,24907,9136,24907,allow,1386,1386,0,22,1544,22,0,1,"High deviation in pkts_sent, NAT Destination Port, Elapsed Time (sec)"
39820,443,15397,443,allow,2642442,95056,2547386,2730,3629,999,1731,1,"High deviation in pkts_sent, Bytes Received, Bytes"
45275,443,51304,443,allow,9908271,123308,9784963,8531,359,1708,6823,1,"High deviation in pkts_sent, Bytes Received, Bytes"
50265,24387,44902,24387,allow,330,330,0,6,1200,6,0,1,"High deviation in pkts_sent, NAT Destination Port, Elapsed Time (sec)"
50584,51651,64737,51651,allow,166,166,0,1,1200,1,0,1,"High deviation in NAT Destination Port, Destination Port, Elapsed Time (sec)"
41762,443,13178,443,allow,2306249,52358,2253891,2041,239,447,1594,1,"High deviation in pkts_sent, Bytes Received, Bytes"
50584,49001,15411,49001,allow,889,161,728,3,1200,2,1,1,"High deviation in pkts_sent, NAT Destination Port, Destination Port"
33200,443,11701,443,allow,67123,10708,56415,100,124,41,59,1,"High deviation in pkts_sent, Bytes Received, Bytes"
49293,80,54518,80,allow,75982,15645,60337,88,158,31,57,1,"High deviation in pkts_sent, Bytes Received, Bytes"
53669,59056,24869,59056,allow,70,70,0,2,7,2,0,1,"High deviation in pkts_sent, NAT Destination Port, Destination Port"
61736,443,61172,443,allow,148467,8298,140169,192,17,93,99,1,"High deviation in pkts_sent, Bytes Received, Bytes"
50584,49533,38774,49533,allow,161,161,0,1,1200,1,0,1,"High deviation in NAT Destination Port, Destination Port, Elapsed Time (sec)"
36749,443,54855,443,allow,487330,18074,469256,508,122,148,360,1,"High deviation in pkts_sent, Bytes Received, Bytes"
50584,39812,60344,39812,allow,161,161,0,1,1200,1,0,1,"High deviation in NAT Destination Port, Destination Port, Elapsed Time (sec)"
45562,5228,50425,5228,allow,29298,3627,25671,67,5346,25,42,1,"High deviation in pkts_sent, Elapsed Time (sec), Bytes Received"
51221,31285,26575,31285,allow,2274,924,1350,30,3293,15,15,1,"High deviation in pkts_sent, NAT Destination Port, Elapsed Time (sec)"
57236,443,10665,443,allow,225524,59002,166522,402,78,192,210,1,"High deviation in pkts_sent, Bytes Sent, Bytes"
50584,64027,41636,64027,allow,166,166,0,1,1199,1,0,1,"High deviation in NAT Destination Port, Destination Port, Elapsed Time (sec)"
53671,60416,42593,60416,allow,70,70,0,2,7,2,0,1,"High deviation in pkts_sent, NAT Destination Port, Destination Port"
58509,443,26840,443,allow,13973721,436876,13536845,14039,1629,4929,9110,1,"High deviation in pkts_sent, Bytes Received, Bytes"
52935,443,46702,443,allow,1769338,65258,1704080,1935,1200,735,1200,1,"High deviation in pkts_sent, Bytes Received, Bytes"
27005,50002,4449,50002,allow,1642,126,1516,4,31,2,2,1,"High deviation in pkts_sent, NAT Destination Port, Destination Port"
60427,61137,3652,61137,allow,70,70,0,2,8,2,0,1,"High deviation in pkts_sent, NAT Destination Port, Destination Port"
55641,61762,32816,61762,allow,70,70,0,2,8,2,0,1,"High deviation in pkts_sent, NAT Destination Port, Destination Port"
34424,443,56503,443,allow,773546,29906,743640,881,1166,350,531,1,"High deviation in pkts_sent, Bytes Received, Bytes"
51517,443,20075,443,allow,590874,19818,571056,669,42,271,398,1,"High deviation in pkts_sent, Bytes Received, Bytes"
57245,443,39703,443,allow,170452,9659,160793,224,68,97,127,1,"High deviation in pkts_sent, Bytes Received, Bytes"
59841,80,53537,80,allow,711697,18422,693275,716,50,253,463,1,"High deviation in pkts_sent, Bytes Received, Bytes"
58814,443,50784,443,allow,1549485,41822,1507663,1612,179,520,1092,1,"High deviation in pkts_sent, Bytes Received, Bytes"
27005,50001,15883,50001,allow,1656,126,1530,4,31,2,2,1,"High deviation in pkts_sent, NAT Destination Port, Destination Port"
53177,443,2633,443,allow,6512167,186944,6325223,6347,1216,2089,4258,1,"High deviation in pkts_sent, Bytes Received, Bytes"
57247,443,40506,443,allow,93673,74276,19397,194,67,111,83,1,"High deviation in pkts_sent, Bytes Sent, Bytes"
57246,443,63215,443,allow,360050,17258,342792,432,68,185,247,1,"High deviation in pkts_sent, Bytes Received, Bytes"
57244,443,45761,443,allow,230914,10401,220513,290,76,121,169,1,"High deviation in pkts_sent, Bytes Received, Bytes"
50584,56221,62822,56221,allow,166,166,0,1,1199,1,0,1,"High deviation in NAT Destination Port, Destination Port, Elapsed Time (sec)"
57242,443,22643,443,allow,291104,18601,272503,413,77,186,227,1,"High deviation in pkts_sent, Bytes Received, Bytes"
65520,56330,49409,56330,allow,558,318,240,9,143,5,4,1,"High deviation in pkts_sent, NAT Destination Port, Destination Port"
55633,54638,31495,54638,allow,504,318,186,8,15,5,3,1,"High deviation in pkts_sent, NAT Destination Port, Destination Port"
57248,443,32420,443,allow,1021056,38101,982955,1183,64,501,682,1,"High deviation in pkts_sent, Bytes Received, Bytes"
36313,443,38446,443,allow,55608,48375,7233,140,95,81,59,1,"High deviation in pkts_sent, Bytes Sent, Bytes"
57470,49001,13810,49001,allow,166,166,0,1,1200,1,0,1,"High deviation in NAT Destination Port, Destination Port, Elapsed Time (sec)"
50584,50901,9302,50901,allow,166,166,0,1,1199,1,0,1,"High deviation in NAT Destination Port, Destination Port, Elapsed Time (sec)"
50584,32808,19666,32808,allow,166,166,0,1,1199,1,0,1,"High deviation in NAT Destination Port, Destination Port, Elapsed Time (sec)"
57251,443,64913,443,allow,54515,20774,33741,167,36,88,79,1,"High deviation in pkts_sent, Bytes Sent, Bytes"
59773,443,43322,443,allow,165464,10322,155142,189,71,69,120,1,"High deviation in pkts_sent, Bytes Received, Bytes"
60423,52001,49584,52001,allow,260,140,120,5,9,3,2,1,"High deviation in pkts_sent, NAT Destination Port, Destination Port"
37774,443,33221,443,allow,282171,13444,268727,377,201,175,202,1,"High deviation in pkts_sent, Bytes Received, Bytes"
60719,443,32077,443,allow,71523,19991,51532,112,41,59,53,1,"High deviation in pkts_sent, Bytes Sent, Bytes"
59844,80,25773,80,allow,397391,8624,388767,380,49,118,262,1,"High deviation in pkts_sent, Bytes Received, Bytes"
57829,443,7967,443,allow,981499,39775,941724,1109,291,439,670,1,"High deviation in pkts_sent, Bytes Received, Bytes"
50172,443,42288,443,allow,152228,30166,122062,215,153,92,123,1,"High deviation in pkts_sent, Bytes Received, Bytes"
63843,53603,44636,53603,allow,312,132,180,6,6,3,3,1,"High deviation in pkts_sent, NAT Destination Port, Destination Port"
51169,443,30146,443,allow,975832,29038,946794,991,51,341,650,1,"High deviation in pkts_sent, Bytes Received, Bytes"
57250,443,30751,443,allow,345315,16365,328950,459,36,206,253,1,"High deviation in pkts_sent, Bytes Received, Bytes"
60428,55172,58181,55172,allow,320,140,180,6,7,3,3,1,"High deviation in pkts_sent, NAT Destination Port, Destination Port"
55634,58846,20945,58846,allow,70,70,0,1,5,1,0,1,"High deviation in NAT Destination Port, Destination Port, NAT Source Port"
52407,443,53495,443,allow,100194,6406,93788,171,24,85,86,1,"High deviation in pkts_sent, Bytes Received, Bytes"
27005,50003,20006,50003,allow,887,126,761,2,31,1,1,1,"High deviation in NAT Destination Port, Destination Port, Bytes Received"
57470,58753,38248,58753,allow,166,166,0,1,1199,1,0,1,"High deviation in NAT Destination Port, Destination Port, Elapsed Time (sec)"
46328,443,26248,443,allow,446664,48034,398630,698,223,326,372,1,"High deviation in pkts_sent, Bytes Received, Bytes"
27005,50003,10902,50003,allow,1636,126,1510,4,31,2,2,1,"High deviation in pkts_sent, NAT Destination Port, Destination Port"
57288,443,58142,443,allow,116807,21042,95765,315,19,161,154,1,"High deviation in pkts_sent, Bytes Received, Bytes"
62952,38741,48558,38741,allow,18963,9580,9383,211,348,109,102,1,"High deviation in pkts_sent, NAT Destination Port, Bytes Sent"
57470,43836,52896,43836,allow,402,132,270,6,1209,3,3,1,"High deviation in pkts_sent, NAT Destination Port, Destination Port"
52317,5223,5494,5223,allow,6070,1779,4291,17,3600,8,9,1,"High deviation in pkts_sent, Elapsed Time (sec), NAT Destination Port"
57470,49160,41673,49160,allow,132,132,0,3,1199,3,0,1,"High deviation in pkts_sent, NAT Destination Port, Destination Port"
38508,443,38508,443,allow,279067,22871,256196,327,90,145,182,1,"High deviation in pkts_sent, Bytes Received, Bytes"
44847,51365,14892,51365,allow,509,150,359,2,1200,1,1,1,"High deviation in NAT Destination Port, Destination Port, Elapsed Time (sec)"
50584,49647,42268,49647,allow,523,161,362,2,1200,1,1,1,"High deviation in NAT Destination Port, Destination Port, Elapsed Time (sec)"
54522,443,63026,443,allow,4728282,133897,4594385,4756,80,1650,3106,1,"High deviation in pkts_sent, Bytes Received, Bytes"
58701,80,43595,80,allow,12499310,161518,12337792,10496,70,2325,8171,1,"High deviation in pkts_sent, Bytes Received, Bytes"
61734,443,59784,443,allow,231110,14545,216565,307,18,154,153,1,"High deviation in pkts_sent, Bytes Received, Bytes"
50584,48493,7175,48493,allow,161,161,0,1,1200,1,0,1,"High deviation in NAT Destination Port, Destination Port, Elapsed Time (sec)"
38770,443,52968,443,allow,140155,6367,133788,173,145,62,111,1,"High deviation in pkts_sent, Bytes Received, Bytes"
50584,63591,44593,63591,allow,161,161,0,2,1200,2,0,1,"High deviation in pkts_sent, NAT Destination Port, Destination Port"
37371,5228,12391,5228,allow,3277,1954,1323,27,3600,14,13,1,"High deviation in pkts_sent, Elapsed Time (sec), NAT Destination Port"
30960,45713,7044,45713,allow,330,330,0,6,3610,6,0,1,"High deviation in pkts_sent, NAT Destination Port, Elapsed Time (sec)"
54087,443,2699,443,allow,2637658,83234,2554424,2794,140,929,1865,1,"High deviation in pkts_sent, Bytes Received, Bytes"
60373,443,19425,443,allow,3875761,85491,3790270,3838,89,1315,2523,1,"High deviation in pkts_sent, Bytes Received, Bytes"
50584,62758,61935,62758,allow,161,161,0,2,1199,2,0,1,"High deviation in pkts_sent, NAT Destination Port, Destination Port"
38095,443,38095,443,allow,247172,58810,188362,325,90,174,151,1,"High deviation in pkts_sent, Bytes Sent, Bytes"
33967,5222,10318,5222,allow,74654,9673,64981,221,616,106,115,1,"High deviation in pkts_sent, Bytes Received, Bytes"
50584,42504,10356,42504,allow,161,161,0,2,1199,2,0,1,"High deviation in pkts_sent, NAT Destination Port, Destination Port"
65480,443,49360,443,allow,310863,9840,301023,323,16,115,208,1,"High deviation in pkts_sent, Bytes Received, Bytes"
50584,50545,46451,50545,allow,166,166,0,1,1199,1,0,1,"High deviation in NAT Destination Port, Destination Port, Elapsed Time (sec)"
50265,51413,14137,51413,allow,460,150,310,2,1200,1,1,1,"High deviation in NAT Destination Port, Destination Port, Elapsed Time (sec)"
50584,61421,62887,61421,allow,166,166,0,1,1199,1,0,1,"High deviation in NAT Destination Port, Destination Port, Elapsed Time (sec)"
50584,64368,19845,64368,allow,161,161,0,2,1200,2,0,1,"High deviation in pkts_sent, NAT Destination Port, Destination Port"
50584,49001,14591,49001,allow,166,166,0,1,1199,1,0,1,"High deviation in NAT Destination Port, Destination Port, Elapsed Time (sec)"
50584,18066,56366,18066,allow,1705,536,1169,5,1200,4,1,1,"High deviation in pkts_sent, NAT Destination Port, Elapsed Time (sec)"
57470,24451,64687,24451,allow,166,166,0,1,1200,1,0,1,"High deviation in NAT Destination Port, Elapsed Time (sec), Destination Port"
6882,41923,41297,41923,allow,492,150,342,2,1200,1,1,1,"High deviation in NAT Destination Port, Destination Port, Elapsed Time (sec)"
50584,40926,15001,40926,allow,166,166,0,1,1199,1,0,1,"High deviation in NAT Destination Port, Destination Port, Elapsed Time (sec)"
30188,64511,50224,64511,allow,854,150,704,4,1200,2,2,1,"High deviation in pkts_sent, NAT Destination Port, Destination Port"
65479,443,61050,443,allow,92397,4379,88018,102,16,37,65,1,"High deviation in pkts_sent, Bytes Received, Bytes"
36067,443,36067,443,allow,228681,29484,199197,303,110,149,154,1,"High deviation in pkts_sent, Bytes Received, Bytes"
56120,443,26246,443,allow,551795,18805,532990,603,43,220,383,1,"High deviation in pkts_sent, Bytes Received, Bytes"
34365,443,34038,443,allow,223826,45909,177917,356,44,176,180,1,"High deviation in pkts_sent, Bytes Received, Bytes"
35271,443,35271,443,allow,134405,6968,127437,187,97,85,102,1,"High deviation in pkts_sent, Bytes Received, Bytes"
56504,443,16127,443,allow,4467051,102279,4364772,4340,46,1452,2888,1,"High deviation in pkts_sent, Bytes Received, Bytes"
55087,443,24413,443,allow,101356,10743,90613,178,31,90,88,1,"High deviation in pkts_sent, Bytes Received, Bytes"
54975,443,15865,443,allow,441892,86941,354951,716,73,343,373,1,"High deviation in pkts_sent, Bytes Received, Bytes"
36053,443,36053,443,allow,79562,17054,62508,111,109,54,57,1,"High deviation in pkts_sent, Bytes Received, Bytes"
49160,40527,18392,40527,allow,854,150,704,4,1201,2,2,1,"High deviation in pkts_sent, NAT Destination Port, Destination Port"
30960,45714,65388,45714,allow,330,330,0,6,3609,6,0,1,"High deviation in pkts_sent, NAT Destination Port, Elapsed Time (sec)"
56113,443,21683,443,allow,103486,7416,96070,161,42,82,79,1,"High deviation in pkts_sent, Bytes Received, Bytes"
56119,443,4138,443,allow,144290,9387,134903,217,42,110,107,1,"High deviation in pkts_sent, Bytes Received, Bytes"
57470,51413,47712,51413,allow,543,166,377,2,1199,1,1,1,"High deviation in NAT Destination Port, Destination Port, Elapsed Time (sec)"
36144,443,36144,443,allow,170890,13800,157090,246,97,123,123,1,"High deviation in pkts_sent, Bytes Received, Bytes"
35449,443,35449,443,allow,157435,9243,148192,220,97,101,119,1,"High deviation in pkts_sent, Bytes Received, Bytes"
56688,443,37544,443,allow,32780,6864,25916,142,345,57,85,1,"High deviation in pkts_sent, Bytes Received, Bytes"
54978,443,60259,443,allow,225539,162879,62660,476,70,262,214,1,"High deviation in pkts_sent, Bytes Sent, Bytes"
56118,443,45922,443,allow,187927,12115,175812,276,42,137,139,1,"High deviation in pkts_sent, Bytes Received, Bytes"
57606,443,40796,443,allow,11986,3075,8911,60,4981,31,29,1,"High deviation in pkts_sent, Elapsed Time (sec), Bytes Sent"
58286,20,58286,20,allow,100132,17467,82665,325,619,168,157,1,"High deviation in pkts_sent, Bytes Received, Bytes"
56736,443,56736,443,allow,120441,7846,112595,167,61,76,91,1,"High deviation in pkts_sent, Bytes Received, Bytes"
57470,49160,27757,49160,allow,402,132,270,6,1209,3,3,1,"High deviation in pkts_sent, NAT Destination Port, Destination Port"
56785,443,18418,443,allow,288525,15601,272924,383,33,193,190,1,"High deviation in pkts_sent, Bytes Received, Bytes"
56968,80,44242,80,allow,53181,50384,2797,75,20,39,36,1,"High deviation in pkts_sent, Bytes Sent, Bytes"
61733,443,10616,443,allow,168812,5693,163119,186,21,68,118,1,"High deviation in pkts_sent, Bytes Received, Bytes"
57470,47004,40280,47004,allow,152,152,0,2,1200,2,0,1,"High deviation in pkts_sent, NAT Destination Port, Destination Port"
37587,5228,8359,5228,allow,5509,2203,3306,22,3600,10,12,1,"High deviation in pkts_sent, Elapsed Time (sec), NAT Destination Port"
30960,45705,10345,45705,allow,396,396,0,7,3617,7,0,1,"High deviation in pkts_sent, NAT Destination Port, Elapsed Time (sec)"
53644,58085,53471,58085,allow,70,70,0,1,4,1,0,1,"High deviation in NAT Destination Port, Destination Port, NAT Source Port"
49235,80,47953,80,allow,1783342,58977,1724365,1613,162,445,1168,1,"High deviation in pkts_sent, Bytes Received, Bytes"
49236,80,22987,80,allow,1904818,59945,1844873,1747,162,498,1249,1,"High deviation in pkts_sent, Bytes Received, Bytes"
56786,443,61415,443,allow,238132,13988,224144,317,32,161,156,1,"High deviation in pkts_sent, Bytes Received, Bytes"
49260,80,56058,80,allow,2013987,64000,1949987,1818,160,504,1314,1,"High deviation in pkts_sent, Bytes Received, Bytes"
49179,443,25006,443,allow,686176,17574,668602,702,18,252,450,1,"High deviation in pkts_sent, Bytes Received, Bytes"
49446,443,57880,443,allow,1280822,27768,1253054,1241,40,365,876,1,"High deviation in pkts_sent, Bytes Received, Bytes"
49237,80,10310,80,allow,1934086,60476,1873610,1754,162,493,1261,1,"High deviation in pkts_sent, Bytes Received, Bytes"
57188,443,9507,443,allow,20317684,620294,19697390,20965,186,6716,14249,1,"High deviation in pkts_sent, Bytes Received, Bytes"
49234,80,29641,80,allow,1103248,36317,1066931,1001,162,276,725,1,"High deviation in pkts_sent, Bytes Received, Bytes"
53662,55043,16806,55043,allow,320,140,180,6,6,3,3,1,"High deviation in pkts_sent, NAT Destination Port, Destination Port"
6881,37232,47143,37232,allow,502,150,352,2,1199,1,1,1,"High deviation in NAT Destination Port, Destination Port, Elapsed Time (sec)"
48817,30201,48817,30201,allow,469,150,319,2,1200,1,1,1,"High deviation in NAT Destination Port, Elapsed Time (sec), Destination Port"
60718,443,23092,443,allow,71105,20647,50458,107,38,53,54,1,"High deviation in pkts_sent, Bytes Sent, Bytes"
39423,443,60458,443,allow,121145,3578,117567,128,77,39,89,1,"High deviation in pkts_sent, Bytes Received, Bytes"
53656,58624,15076,58624,allow,70,70,0,2,8,2,0,1,"High deviation in pkts_sent, NAT Destination Port, Destination Port"
54990,80,38273,80,allow,9054746,285623,8769123,10474,214,4673,5801,1,"High deviation in pkts_sent, Bytes Received, Bytes"
57470,40870,29859,40870,allow,535,163,372,2,1200,1,1,1,"High deviation in NAT Destination Port, Destination Port, Elapsed Time (sec)"
57470,59216,60669,59216,allow,594,594,0,10,1200,10,0,1,"High deviation in pkts_sent, NAT Destination Port, Destination Port"
38111,443,61640,443,allow,566856,28278,538578,737,37,351,386,1,"High deviation in pkts_sent, Bytes Received, Bytes"
39416,443,22181,443,allow,621104,12188,608916,575,78,149,426,1,"High deviation in pkts_sent, Bytes Received, Bytes"
39422,443,26393,443,allow,557795,16003,541792,528,76,139,389,1,"High deviation in pkts_sent, Bytes Received, Bytes"
50819,443,23164,443,allow,1663508,63528,1599980,1853,251,692,1161,1,"High deviation in pkts_sent, Bytes Received, Bytes"
54989,80,38298,80,allow,8159037,271621,7887416,9644,214,4424,5220,1,"High deviation in pkts_sent, Bytes Received, Bytes"
10090,443,45576,443,allow,20612,7872,12740,57,643,21,36,1,"High deviation in pkts_sent, Bytes Sent, Bytes"
55626,63805,23725,63805,allow,70,70,0,1,5,1,0,1,"High deviation in NAT Destination Port, Destination Port, NAT Source Port"
51826,58925,47237,58925,allow,70,70,0,1,4,1,0,1,"High deviation in NAT Destination Port, Destination Port, NAT Source Port"
50827,443,7368,443,allow,388366,15919,372447,435,219,158,277,1,"High deviation in pkts_sent, Bytes Received, Bytes"
60613,443,54092,443,allow,154465,11473,142992,244,212,101,143,1,"High deviation in pkts_sent, Bytes Received, Bytes"
47982,443,20773,443,allow,83558,8567,74991,180,171,92,88,1,"High deviation in pkts_sent, Bytes Received, Bytes"
60612,443,17628,443,allow,117190,11380,105810,171,212,67,104,1,"High deviation in pkts_sent, Bytes Received, Bytes"
56812,49600,3950,49600,allow,3060,1569,1491,12,16,7,5,1,"High deviation in pkts_sent, NAT Destination Port, Destination Port"
35372,443,41929,443,allow,269750,10062,259688,285,152,92,193,1,"High deviation in pkts_sent, Bytes Received, Bytes"
50829,443,2487,443,allow,1445207,43930,1401277,1562,219,556,1006,1,"High deviation in pkts_sent, Bytes Received, Bytes"
6881,32056,50769,32056,allow,509,150,359,2,1199,1,1,1,"High deviation in NAT Destination Port, Destination Port, Elapsed Time (sec)"
39094,443,9909,443,allow,350650,19028,331622,494,83,251,243,1,"High deviation in pkts_sent, Bytes Received, Bytes"
27005,50019,8990,50019,allow,877,126,751,2,31,1,1,1,"High deviation in NAT Destination Port, Destination Port, Bytes Received"
57470,49294,38558,49294,allow,132,132,0,3,1199,3,0,1,"High deviation in pkts_sent, NAT Destination Port, Destination Port"
57470,44046,49985,44046,allow,166,166,0,1,1199,1,0,1,"High deviation in NAT Destination Port, Destination Port, Elapsed Time (sec)"
57470,44172,25895,44172,allow,353,166,187,2,1199,1,1,1,"High deviation in NAT Destination Port, Destination Port, Elapsed Time (sec)"
52936,5228,12223,5228,allow,9201,2130,7071,41,5528,21,20,1,"High deviation in pkts_sent, Elapsed Time (sec), NAT Destination Port"
49225,443,49225,443,allow,854266,56622,797644,969,98,420,549,1,"High deviation in pkts_sent, Bytes Received, Bytes"
60292,8630,2625,8630,allow,324,250,74,5,3605,4,1,1,"High deviation in pkts_sent, Elapsed Time (sec), NAT Destination Port"
55002,80,41422,80,allow,10872190,337459,10534731,12500,208,5532,6968,1,"High deviation in pkts_sent, Bytes Received, Bytes"
56811,44008,31634,44008,allow,3034,1547,1487,12,16,7,5,1,"High deviation in pkts_sent, NAT Destination Port, Destination Port"
41713,443,59804,443,allow,61983,10061,51922,85,130,35,50,1,"High deviation in pkts_sent, Bytes Received, Bytes"
57470,42329,52817,42329,allow,1782,1782,0,28,1559,28,0,1,"High deviation in pkts_sent, NAT Destination Port, Destination Port"
60611,443,2263,443,allow,478331,21023,457308,573,211,201,372,1,"High deviation in pkts_sent, Bytes Received, Bytes"
59982,80,63868,80,allow,207418,4580,202838,194,143,50,144,1,"High deviation in pkts_sent, Bytes Received, Bytes"
50820,443,64516,443,allow,2760048,78471,2681577,2863,250,962,1901,1,"High deviation in pkts_sent, Bytes Received, Bytes"
60610,443,53274,443,allow,187258,9720,177538,225,211,86,139,1,"High deviation in pkts_sent, Bytes Received, Bytes"
49226,443,49226,443,allow,118943,24432,94511,156,96,79,77,1,"High deviation in pkts_sent, Bytes Received, Bytes"
50826,443,44270,443,allow,820870,30523,790347,918,218,337,581,1,"High deviation in pkts_sent, Bytes Received, Bytes"
60417,55100,62868,55100,allow,164,70,94,2,5,1,1,1,"High deviation in NAT Destination Port, Destination Port, NAT Source Port"
62330,443,31152,443,allow,21361086,218978,21142108,16512,170,2203,14309,1,"High deviation in pkts_sent, Bytes Received, Bytes"
39095,443,56882,443,allow,310402,12194,298208,374,82,157,217,1,"High deviation in pkts_sent, Bytes Received, Bytes"
60063,443,64614,443,allow,432803,9264,423539,427,141,135,292,1,"High deviation in pkts_sent, Bytes Received, Bytes"
39096,443,59336,443,allow,1268772,32833,1235939,1288,81,409,879,1,"High deviation in pkts_sent, Bytes Received, Bytes"
60019,443,11836,443,allow,76774,9184,67590,104,143,41,63,1,"High deviation in pkts_sent, Bytes Received, Bytes"
57470,44919,55339,44919,allow,166,166,0,1,1199,1,0,1,"High deviation in NAT Destination Port, Destination Port, Elapsed Time (sec)"
60083,443,30237,443,allow,490571,27526,463045,511,141,170,341,1,"High deviation in pkts_sent, Bytes Received, Bytes"
55001,80,28763,80,allow,9249354,297929,8951425,10789,208,4872,5917,1,"High deviation in pkts_sent, Bytes Received, Bytes"
33252,443,7874,443,allow,89817,21083,68734,148,36,77,71,1,"High deviation in pkts_sent, Bytes, Bytes Sent"
50828,443,8189,443,allow,178483,7778,170705,219,218,90,129,1,"High deviation in pkts_sent, Bytes Received, Bytes"
60018,443,59209,443,allow,117023,8825,108198,138,143,49,89,1,"High deviation in pkts_sent, Bytes Received, Bytes"
55623,62853,62347,62853,allow,504,318,186,8,15,5,3,1,"High deviation in pkts_sent, NAT Destination Port, Destination Port"
51221,57522,58823,57522,allow,481,150,331,2,1200,1,1,1,"High deviation in NAT Destination Port, Destination Port, Elapsed Time (sec)"
60373,80,60373,80,allow,116680,5773,110907,126,21,46,80,1,"High deviation in pkts_sent, Bytes Received, Bytes"
49227,443,49227,443,allow,155471,20626,134845,193,95,92,101,1,"High deviation in pkts_sent, Bytes Received, Bytes"
51819,59208,18687,59208,allow,66,66,0,2,8,2,0,1,"High deviation in pkts_sent, NAT Destination Port, Destination Port"
30960,45708,10232,45708,allow,330,330,0,6,3609,6,0,1,"High deviation in pkts_sent, NAT Destination Port, Elapsed Time (sec)"
50584,58516,43586,58516,allow,161,161,0,1,1200,1,0,1,"High deviation in NAT Destination Port, Destination Port, Elapsed Time (sec)"
57470,51413,13214,51413,allow,490,163,327,2,1200,1,1,1,"High deviation in NAT Destination Port, Destination Port, Elapsed Time (sec)"
57470,51413,34257,51413,allow,508,163,345,2,1200,1,1,1,"High deviation in NAT Destination Port, Destination Port, Elapsed Time (sec)"
19473,28109,14230,28109,allow,468,149,319,2,1200,1,1,1,"High deviation in NAT Destination Port, Elapsed Time (sec), Destination Port"
57470,43259,40741,43259,allow,517,163,354,2,1200,1,1,1,"High deviation in NAT Destination Port, Destination Port, Elapsed Time (sec)"
49441,443,28685,443,allow,2921276,89544,2831732,3090,63,1086,2004,1,"High deviation in pkts_sent, Bytes Received, Bytes"
65478,443,30120,443,allow,92279,4799,87480,107,16,43,64,1,"High deviation in pkts_sent, Bytes Received, Bytes"
60211,443,55686,443,allow,126490514,2726981,123763533,123275,553,41466,81809,1,"High deviation in pkts_sent, Bytes Received, Bytes"
60732,443,1345,443,allow,193520,11019,182501,280,276,140,140,1,"High deviation in pkts_sent, Bytes Received, Bytes"
65477,443,34529,443,allow,409770,12150,397620,421,16,148,273,1,"High deviation in pkts_sent, Bytes Received, Bytes"
33473,443,49097,443,allow,146684,25233,121451,183,189,75,108,1,"High deviation in pkts_sent, Bytes Received, Bytes"
56823,50291,65479,50291,allow,316,136,180,6,6,3,3,1,"High deviation in pkts_sent, NAT Destination Port, Destination Port"
52405,443,45940,443,allow,227267,18022,209245,424,38,239,185,1,"High deviation in pkts_sent, Bytes Received, Bytes"
48734,443,7322,443,allow,256887,11565,245322,293,56,112,181,1,"High deviation in pkts_sent, Bytes Received, Bytes"
60372,80,60372,80,allow,186272,9792,176480,216,21,93,123,1,"High deviation in pkts_sent, Bytes Received, Bytes"
57470,18531,64727,18531,allow,166,166,0,1,1200,1,0,1,"High deviation in NAT Destination Port, Elapsed Time (sec), Destination Port"
50584,38496,45984,38496,allow,166,166,0,1,1200,1,0,1,"High deviation in NAT Destination Port, Destination Port, Elapsed Time (sec)"
57470,60560,62247,60560,allow,527,166,361,2,1200,1,1,1,"High deviation in NAT Destination Port, Destination Port, Elapsed Time (sec)"
6882,64287,36114,64287,allow,228,118,110,2,1200,1,1,1,"High deviation in NAT Destination Port, Destination Port, Elapsed Time (sec)"
55634,58846,18331,58846,allow,70,70,0,2,8,2,0,1,"High deviation in pkts_sent, NAT Destination Port, Destination Port"
57470,51413,27069,51413,allow,807,275,532,4,1200,2,2,1,"High deviation in pkts_sent, NAT Destination Port, Destination Port"
57470,45340,41159,45340,allow,527,166,361,2,1200,1,1,1,"High deviation in NAT Destination Port, Destination Port, Elapsed Time (sec)"
57494,443,51749,443,allow,2435128,54736,2380392,2151,346,331,1820,1,"High deviation in pkts_sent, Bytes Received, Bytes"
57470,44573,53035,44573,allow,883,288,595,4,1200,2,2,1,"High deviation in pkts_sent, NAT Destination Port, Destination Port"
57470,65534,12773,65534,allow,773,271,502,4,1200,2,2,1,"High deviation in pkts_sent, NAT Destination Port, Destination Port"
50584,63015,51175,63015,allow,166,166,0,1,1200,1,0,1,"High deviation in NAT Destination Port, Destination Port, Elapsed Time (sec)"
57470,32517,51554,32517,allow,166,166,0,1,1199,1,0,1,"High deviation in NAT Destination Port, Destination Port, Elapsed Time (sec)"
57470,51413,6363,51413,allow,493,166,327,2,1200,1,1,1,"High deviation in NAT Destination Port, Destination Port, Elapsed Time (sec)"
50584,61867,27152,61867,allow,166,166,0,1,1200,1,0,1,"High deviation in NAT Destination Port, Destination Port, Elapsed Time (sec)"
57470,34590,16143,34590,allow,527,166,361,2,1200,1,1,1,"High deviation in NAT Destination Port, Destination Port, Elapsed Time (sec)"
57470,46487,30671,46487,allow,527,166,361,2,1200,1,1,1,"High deviation in NAT Destination Port, Destination Port, Elapsed Time (sec)"
57470,46941,64707,46941,allow,899,288,611,4,1199,2,2,1,"High deviation in pkts_sent, NAT Destination Port, Destination Port"
57470,51413,16094,51413,allow,700,275,425,4,1200,2,2,1,"High deviation in pkts_sent, NAT Destination Port, Destination Port"
44847,51572,8318,51572,allow,509,150,359,2,1200,1,1,1,"High deviation in NAT Destination Port, Destination Port, Elapsed Time (sec)"
57470,43576,31912,43576,allow,545,166,379,2,1200,1,1,1,"High deviation in NAT Destination Port, Destination Port, Elapsed Time (sec)"
37842,443,37842,443,allow,109189,6692,102497,151,80,69,82,1,"High deviation in pkts_sent, Bytes Received, Bytes"
59134,80,59134,80,allow,104133,2163,101970,103,15,32,71,1,"High deviation in pkts_sent, Bytes Received, Bytes"
57470,22070,58715,22070,allow,559,198,361,5,1200,4,1,1,"High deviation in pkts_sent, NAT Destination Port, Elapsed Time (sec)"
57470,34879,21991,34879,allow,1914,1914,0,30,1766,30,0,1,"High deviation in pkts_sent, NAT Destination Port, Elapsed Time (sec)"
35461,5228,26150,5228,allow,8648,2111,6537,40,7038,21,19,1,"High deviation in pkts_sent, Elapsed Time (sec), NAT Destination Port"
52319,443,62232,443,allow,569666,25343,544323,721,46,320,401,1,"High deviation in pkts_sent, Bytes Received, Bytes"
53123,59228,59037,59228,allow,70,70,0,1,4,1,0,1,"High deviation in NAT Destination Port, Destination Port, NAT Source Port"
42557,443,48761,443,allow,123082,8734,114348,200,84,101,99,1,"High deviation in pkts_sent, Bytes Received, Bytes"
53631,43562,1567,43562,allow,492,306,186,8,15,5,3,1,"High deviation in pkts_sent, NAT Destination Port, Destination Port"
49006,443,37569,443,allow,119425284,929428,118495856,93687,498,9675,84012,1,"High deviation in pkts_sent, Bytes Received, Bytes"
38576,443,38576,443,allow,225915,9896,216019,283,80,128,155,1,"High deviation in pkts_sent, Bytes Received, Bytes"
59979,443,21635,443,allow,30171,25514,4657,77,37,42,35,1,"High deviation in pkts_sent, Bytes Sent, Bytes"
21133,63622,33830,63622,allow,150,150,0,1,1199,1,0,1,"High deviation in NAT Destination Port, Destination Port, Elapsed Time (sec)"
57470,51413,18747,51413,allow,604,275,329,4,1199,2,2,1,"High deviation in pkts_sent, NAT Destination Port, Destination Port"
57614,80,57614,80,allow,470276,8994,461282,388,25,75,313,1,"High deviation in pkts_sent, Bytes Received, Bytes"
51920,443,50819,443,allow,98155,20830,77325,151,103,70,81,1,"High deviation in pkts_sent, Bytes Received, Bytes"
57617,80,57617,80,allow,542818,11392,531426,466,25,106,360,1,"High deviation in pkts_sent, Bytes Received, Bytes"
53979,80,42117,80,allow,64091,62467,1624,61,16,48,13,1,"High deviation in pkts_sent, Bytes Sent, Bytes"
6881,34190,52438,34190,allow,509,150,359,2,1200,1,1,1,"High deviation in NAT Destination Port, Destination Port, Elapsed Time (sec)"
57615,80,57615,80,allow,126266,7980,118286,126,25,37,89,1,"High deviation in pkts_sent, Bytes Received, Bytes"
50265,48982,51729,48982,allow,480,149,331,2,1200,1,1,1,"High deviation in NAT Destination Port, Destination Port, Elapsed Time (sec)"
50265,65535,43978,65535,allow,222,132,90,4,1210,3,1,1,"High deviation in pkts_sent, NAT Destination Port, Destination Port"
50152,80,46738,80,allow,731402,17622,713780,600,97,116,484,1,"High deviation in pkts_sent, Bytes Received, Bytes"
63129,47117,14419,47117,allow,574,448,126,10,25,8,2,1,"High deviation in pkts_sent, NAT Destination Port, Destination Port"
57613,80,57613,80,allow,349583,9149,340434,298,25,62,236,1,"High deviation in pkts_sent, Bytes Received, Bytes"
33409,53,6047,53,allow,241272,234761,6511,2872,89,2833,39,1,"High deviation in pkts_sent, Bytes Sent, Packets"
57616,80,57616,80,allow,266789,7684,259105,234,25,54,180,1,"High deviation in pkts_sent, Bytes Received, Bytes"
23725,80,23725,80,allow,1100980,31101,1069879,1210,19,462,748,1,"High deviation in pkts_sent, Bytes Received, Bytes"
49198,443,22902,443,allow,533813,25885,507928,678,50,308,370,1,"High deviation in pkts_sent, Bytes Received, Bytes"
35796,443,15213,443,allow,664348,23858,640490,757,119,292,465,1,"High deviation in pkts_sent, Bytes Received, Bytes"
57618,80,57618,80,allow,265909,7294,258615,235,25,55,180,1,"High deviation in pkts_sent, Bytes Received, Bytes"
17750,27517,53975,27517,allow,491,150,341,2,1200,1,1,1,"High deviation in NAT Destination Port, Elapsed Time (sec), Destination Port"
56806,46903,25071,46903,allow,3060,1569,1491,12,17,7,5,1,"High deviation in pkts_sent, NAT Destination Port, Destination Port"
50973,80,57219,80,allow,314164,13077,301087,356,25,144,212,1,"High deviation in pkts_sent, Bytes Received, Bytes"
51813,63933,44889,63933,allow,66,66,0,1,5,1,0,1,"High deviation in NAT Destination Port, Destination Port, NAT Source Port"
53632,58037,54997,58037,allow,70,70,0,1,5,1,0,1,"High deviation in NAT Destination Port, Destination Port, NAT Source Port"
43154,80,38984,80,allow,139303,9065,130238,210,20,120,90,1,"High deviation in pkts_sent, Bytes Received, Bytes"
37965,62918,1138,62918,allow,489,149,340,2,1200,1,1,1,"High deviation in NAT Destination Port, Destination Port, Elapsed Time (sec)"
44783,443,27769,443,allow,4173582,66515,4107067,3494,129,510,2984,1,"High deviation in pkts_sent, Bytes Received, Bytes"
65355,443,1822,443,allow,3563945,186679,3377266,4424,723,1877,2547,1,"High deviation in pkts_sent, Bytes Received, Bytes"
59262,5228,3053,5228,allow,7054,2076,4978,32,5115,11,21,1,"High deviation in pkts_sent, Elapsed Time (sec), NAT Destination Port"
5236,35120,49591,35120,allow,23369,64,23305,65,31,2,63,1,"High deviation in pkts_sent, NAT Destination Port, Bytes Received"
53644,58085,31937,58085,allow,70,70,0,2,7,2,0,1,"High deviation in pkts_sent, NAT Destination Port, Destination Port"
6881,50321,40130,50321,allow,238,118,120,2,1199,1,1,1,"High deviation in NAT Destination Port, Destination Port, Elapsed Time (sec)"
53239,443,22787,443,allow,982624,22331,960293,976,137,293,683,1,"High deviation in pkts_sent, Bytes Received, Bytes"
41619,443,17467,443,allow,188529,10173,178356,248,256,93,155,1,"High deviation in pkts_sent, Bytes Received, Bytes"
53630,64745,36069,64745,allow,70,70,0,1,4,1,0,1,"High deviation in NAT Destination Port, Destination Port, NAT Source Port"
51826,58925,42484,58925,allow,70,70,0,2,9,2,0,1,"High deviation in pkts_sent, NAT Destination Port, Destination Port"
65356,443,39597,443,allow,3122508,193850,2928658,4050,681,1740,2310,1,"High deviation in pkts_sent, Bytes Received, Bytes"
65374,443,10199,443,allow,629017,29841,599176,758,162,331,427,1,"High deviation in pkts_sent, Bytes Received, Bytes"
65373,443,38852,443,allow,3104883,106687,2998196,3406,190,1320,2086,1,"High deviation in pkts_sent, Bytes Received, Bytes"
33409,53,54982,53,allow,79268,76966,2302,936,88,923,13,1,"High deviation in pkts_sent, Bytes Sent, Packets"
57470,54343,65136,54343,allow,330,330,0,6,1200,6,0,1,"High deviation in pkts_sent, NAT Destination Port, Destination Port"
49906,443,34595,443,allow,159116,5586,153530,191,47,77,114,1,"High deviation in pkts_sent, Bytes Received, Bytes"
48817,51634,48817,51634,allow,480,149,331,2,1200,1,1,1,"High deviation in NAT Destination Port, Destination Port, Elapsed Time (sec)"
54664,443,62017,443,allow,175780,7700,168080,196,36,78,118,1,"High deviation in pkts_sent, Bytes Received, Bytes"
51939,80,10449,80,allow,103732,4081,99651,128,61,55,73,1,"High deviation in pkts_sent, Bytes Received, Bytes"
56529,443,43021,443,allow,266757,6935,259822,274,19,97,177,1,"High deviation in pkts_sent, Bytes Received, Bytes"
57470,51413,59920,51413,allow,528,528,0,9,1199,9,0,1,"High deviation in pkts_sent, NAT Destination Port, Destination Port"
49912,443,43170,443,allow,2048821,56490,1992331,2082,44,522,1560,1,"High deviation in pkts_sent, Bytes Received, Bytes"
55626,63805,65310,63805,allow,70,70,0,2,8,2,0,1,"High deviation in pkts_sent, NAT Destination Port, Destination Port"
51938,80,6039,80,allow,82321,4061,78260,109,61,50,59,1,"High deviation in pkts_sent, Bytes Received, Bytes"
51940,80,62105,80,allow,278312,9722,268590,323,61,135,188,1,"High deviation in pkts_sent, Bytes Received, Bytes"
55877,56036,49566,56036,allow,469,150,319,2,1200,1,1,1,"High deviation in NAT Destination Port, Destination Port, Elapsed Time (sec)"
6882,42505,24055,42505,allow,207,118,89,2,1200,1,1,1,"High deviation in NAT Destination Port, Destination Port, Elapsed Time (sec)"
48337,443,44874,443,allow,227876,8050,219826,236,36,83,153,1,"High deviation in pkts_sent, Bytes Received, Bytes"
41028,80,41028,80,allow,100182,8294,91888,137,127,69,68,1,"High deviation in pkts_sent, Bytes Received, Bytes"
53017,80,53017,80,allow,184725,5028,179697,217,25,75,142,1,"High deviation in pkts_sent, Bytes Received, Bytes"
53019,80,53019,80,allow,181759,5146,176613,216,25,77,139,1,"High deviation in pkts_sent, Bytes Received, Bytes"
51221,52423,24107,52423,allow,322,149,173,2,1201,1,1,1,"High deviation in NAT Destination Port, Destination Port, Elapsed Time (sec)"
53020,80,53020,80,allow,134273,4066,130207,163,22,59,104,1,"High deviation in pkts_sent, Bytes Received, Bytes"
37965,51413,23143,51413,allow,2020,1090,930,18,1200,15,3,1,"High deviation in pkts_sent, NAT Destination Port, Destination Port"
49290,443,20906,443,allow,1629306,22920,1606386,1339,116,262,1077,1,"High deviation in pkts_sent, Bytes Received, Bytes"
57470,29500,37295,29500,allow,2772,2772,0,43,2311,43,0,1,"High deviation in pkts_sent, NAT Destination Port, Elapsed Time (sec)"
53018,80,53018,80,allow,182677,4908,177769,213,25,73,140,1,"High deviation in pkts_sent, Bytes Received, Bytes"
65476,443,36901,443,allow,93073,4939,88134,111,16,45,66,1,"High deviation in pkts_sent, Bytes Received, Bytes"
37965,30982,7359,30982,allow,528,528,0,9,1199,9,0,1,"High deviation in pkts_sent, NAT Destination Port, Elapsed Time (sec)"
50840,80,15901,80,allow,268155,6485,261670,281,25,97,184,1,"High deviation in pkts_sent, Bytes Received, Bytes"
56276,443,43498,443,allow,71414,17145,54269,194,292,91,103,1,"High deviation in pkts_sent, Bytes Sent, Bytes"
48817,10528,48817,10528,allow,2736,1992,744,37,1580,25,12,1,"High deviation in pkts_sent, NAT Destination Port, Elapsed Time (sec)"
65475,443,62261,443,allow,429726,12570,417156,440,16,154,286,1,"High deviation in pkts_sent, Bytes Received, Bytes"
60416,55998,61754,55998,allow,70,70,0,2,8,2,0,1,"High deviation in pkts_sent, NAT Destination Port, Destination Port"
5235,34592,6891,34592,allow,247495,256,247239,361,49,5,356,1,"High deviation in pkts_sent, Bytes Received, Bytes"
57340,3333,57340,3333,allow,24544,10921,13623,171,1095,89,82,1,"High deviation in pkts_sent, Bytes Sent, Bytes"
50974,80,38911,80,allow,181877,8980,172897,207,22,87,120,1,"High deviation in pkts_sent, Bytes Received, Bytes"
60417,55100,30057,55100,allow,258,70,188,4,8,2,2,1,"High deviation in pkts_sent, NAT Destination Port, Destination Port"
45566,443,9859,443,allow,570475,25559,544916,712,32,341,371,1,"High deviation in pkts_sent, Bytes Received, Bytes"
45079,80,36951,80,allow,233914,10359,223555,294,442,136,158,1,"High deviation in pkts_sent, Bytes Received, Bytes"
51434,443,45613,443,allow,12291742,358717,11933025,12485,181,3846,8639,1,"High deviation in pkts_sent, Bytes Received, Bytes"
51508,443,54920,443,allow,98292,24468,73824,179,52,81,98,1,"High deviation in pkts_sent, Bytes Sent, Bytes"
49289,443,60908,443,allow,3890599,46254,3844345,3173,116,609,2564,1,"High deviation in pkts_sent, Bytes Received, Bytes"
53016,80,53016,80,allow,265868,5026,260842,277,24,75,202,1,"High deviation in pkts_sent, Bytes Received, Bytes"
30960,45703,22089,45703,allow,330,330,0,6,3609,6,0,1,"High deviation in pkts_sent, NAT Destination Port, Elapsed Time (sec)"
51969,80,41756,80,allow,7304882,206543,7098339,7398,37,2677,4721,1,"High deviation in pkts_sent, Bytes Received, Bytes"
42040,5228,65521,5228,allow,3467,1977,1490,29,3742,14,15,1,"High deviation in pkts_sent, Elapsed Time (sec), NAT Destination Port"
49225,8080,49225,8080,allow,43790,20134,23656,73,400,45,28,1,"High deviation in pkts_sent, Bytes Sent, Bytes"
51972,80,28549,80,allow,7001170,112187,6888983,6101,29,1546,4555,1,"High deviation in pkts_sent, Bytes Received, Bytes"
53013,80,53013,80,allow,258732,4788,253944,268,25,71,197,1,"High deviation in pkts_sent, Bytes Received, Bytes"
34535,443,2952,443,allow,74325,3719,70606,98,200,44,54,1,"High deviation in pkts_sent, Bytes Received, Bytes"
49416,443,60402,443,allow,625995,31468,594527,722,199,256,466,1,"High deviation in pkts_sent, Bytes Received, Bytes"
50265,43974,25412,43974,allow,132,132,0,3,1200,3,0,1,"High deviation in pkts_sent, NAT Destination Port, Destination Port"
58830,28678,13686,28678,allow,1806,1806,0,22,224,22,0,1,"High deviation in pkts_sent, NAT Destination Port, Destination Port"
60411,58131,27448,58131,allow,70,70,0,1,5,1,0,1,"High deviation in NAT Destination Port, Destination Port, NAT Source Port"
50827,443,28235,443,allow,166814,93487,73327,620,4017,312,308,1,"High deviation in pkts_sent, Bytes Sent, Bytes"
52734,443,39307,443,allow,257777,12962,244815,347,41,162,185,1,"High deviation in pkts_sent, Bytes Received, Bytes"
60013,443,65408,443,allow,145369,7769,137600,224,21,106,118,1,"High deviation in pkts_sent, Bytes Received, Bytes"
35844,443,58126,443,allow,5196,1875,3321,45,5922,12,33,1,"High deviation in pkts_sent, Elapsed Time (sec), Bytes Sent"
37965,63402,11159,63402,allow,2118,858,1260,28,1283,14,14,1,"High deviation in pkts_sent, NAT Destination Port, Destination Port"
57470,52217,58146,52217,allow,1969,730,1239,19,1199,10,9,1,"High deviation in pkts_sent, NAT Destination Port, Destination Port"
52741,443,63085,443,allow,85011,4398,80613,113,26,52,61,1,"High deviation in pkts_sent, Bytes Received, Bytes"
52740,443,65500,443,allow,168753,7954,160799,212,26,95,117,1,"High deviation in pkts_sent, Bytes Received, Bytes"
30960,45701,51481,45701,allow,330,330,0,6,3609,6,0,1,"High deviation in pkts_sent, NAT Destination Port, Elapsed Time (sec)"
40296,80,40296,80,allow,1032410,43358,989052,1356,72,591,765,1,"High deviation in pkts_sent, Bytes Received, Bytes"
20,64488,20,50706,allow,624666,17676,606990,671,14,267,404,1,"High deviation in pkts_sent, Bytes Received, Bytes"
52728,443,50981,443,allow,186399,56439,129960,335,45,170,165,1,"High deviation in pkts_sent, Bytes Sent, Bytes"
52736,443,12534,443,allow,1217451,39642,1177809,1359,39,539,820,1,"High deviation in pkts_sent, Bytes Received, Bytes"
57492,443,47894,443,allow,380975,82011,298964,804,171,343,461,1,"High deviation in pkts_sent, Bytes Received, Bytes"
19473,58093,47634,58093,allow,460,150,310,2,1200,1,1,1,"High deviation in NAT Destination Port, Destination Port, Elapsed Time (sec)"
6881,40783,51733,40783,allow,509,150,359,2,1199,1,1,1,"High deviation in NAT Destination Port, Destination Port, Elapsed Time (sec)"
52733,443,22448,443,allow,613606,29392,584214,757,42,337,420,1,"High deviation in pkts_sent, Bytes Received, Bytes"
53123,59228,32782,59228,allow,70,70,0,2,8,2,0,1,"High deviation in pkts_sent, NAT Destination Port, Destination Port"
49177,443,60972,443,allow,654956,17062,637894,673,18,244,429,1,"High deviation in pkts_sent, Bytes Received, Bytes"
51159,443,36632,443,allow,6405463,157088,6248375,6383,90,2146,4237,1,"High deviation in pkts_sent, Bytes Received, Bytes"
52746,443,40862,443,allow,104383,5038,99345,135,25,62,73,1,"High deviation in pkts_sent, Bytes Received, Bytes"
8283,45858,63554,45858,allow,130,70,60,2,30,1,1,1,"High deviation in NAT Destination Port, Destination Port, Source Port"
46544,443,31614,443,allow,332590,15084,317506,341,139,89,252,1,"High deviation in pkts_sent, Bytes Received, Bytes"
27005,49000,39068,49000,allow,887,126,761,2,30,1,1,1,"High deviation in NAT Destination Port, Destination Port, Bytes Received"
49760,80,49760,80,allow,613303,16858,596445,666,143,251,415,1,"High deviation in pkts_sent, Bytes Received, Bytes"
58794,5222,61380,5222,allow,47445,16812,30633,144,870,65,79,1,"High deviation in pkts_sent, Bytes Sent, Bytes"
50584,60395,46252,60395,allow,166,166,0,1,1200,1,0,1,"High deviation in NAT Destination Port, Destination Port, Elapsed Time (sec)"
52183,443,6530,443,allow,3560269,64410,3495859,2930,132,383,2547,1,"High deviation in pkts_sent, Bytes Received, Bytes"
50584,56209,14402,56209,allow,166,166,0,1,1200,1,0,1,"High deviation in NAT Destination Port, Destination Port, Elapsed Time (sec)"
49633,443,1902,443,allow,60196,10141,50055,122,33,62,60,1,"High deviation in pkts_sent, Bytes Received, Bytes"
53599,47783,42378,47783,allow,618,432,186,9,17,6,3,1,"High deviation in pkts_sent, NAT Destination Port, Destination Port"
53072,443,53072,443,allow,49826,37097,12729,66,163,40,26,1,"High deviation in pkts_sent, Bytes Sent, Bytes"
53597,42845,3911,42845,allow,678,492,186,10,18,7,3,1,"High deviation in pkts_sent, NAT Destination Port, Destination Port"
49352,443,43143,443,allow,2118582,46411,2072171,2066,90,617,1449,1,"High deviation in pkts_sent, Bytes Received, Bytes"
21133,43408,64774,43408,allow,480,149,331,2,1200,1,1,1,"High deviation in NAT Destination Port, Destination Port, Elapsed Time (sec)"
40599,443,12842,443,allow,89724,81316,8408,148,404,69,79,1,"High deviation in pkts_sent, Bytes Sent, Bytes"
30960,45700,20531,45700,allow,330,330,0,6,3609,6,0,1,"High deviation in pkts_sent, NAT Destination Port, Elapsed Time (sec)"
54437,443,40534,443,allow,716056,89267,626789,952,300,368,584,1,"High deviation in pkts_sent, Bytes Received, Bytes"
49897,443,63900,443,allow,113036,13164,99872,191,144,89,102,1,"High deviation in pkts_sent, Bytes Received, Bytes"
48697,5222,62184,5222,allow,8355,4135,4220,79,616,41,38,1,"High deviation in pkts_sent, Bytes Sent, NAT Destination Port"
51800,63796,15243,63796,allow,70,70,0,1,5,1,0,1,"High deviation in NAT Destination Port, Destination Port, Bytes Received"
39435,443,17310,443,allow,2403265,93626,2309639,2795,243,1103,1692,1,"High deviation in pkts_sent, Bytes Received, Bytes"
56970,443,2688,443,allow,20635942,626393,20009549,21680,138,6969,14711,1,"High deviation in pkts_sent, Bytes Received, Bytes"
57545,443,29665,443,allow,25540,8247,17293,187,574,79,108,1,"High deviation in pkts_sent, Bytes Sent, Bytes"
53632,58037,4206,58037,allow,70,70,0,2,8,2,0,1,"High deviation in pkts_sent, NAT Destination Port, Destination Port"
53012,80,53012,80,allow,278027,5087,272940,288,22,76,212,1,"High deviation in pkts_sent, Bytes Received, Bytes"
55691,443,55691,443,allow,165616,8760,156856,199,82,79,120,1,"High deviation in pkts_sent, Bytes Received, Bytes"
54124,443,54124,443,allow,105609,16179,89430,150,84,79,71,1,"High deviation in pkts_sent, Bytes Received, Bytes"
51813,63933,50803,63933,allow,70,70,0,2,8,2,0,1,"High deviation in pkts_sent, NAT Destination Port, Destination Port"
51819,59208,38763,59208,allow,70,70,0,1,5,1,0,1,"High deviation in NAT Destination Port, Destination Port, NAT Source Port"
51817,54601,57265,54601,allow,316,136,180,6,7,3,3,1,"High deviation in pkts_sent, NAT Destination Port, Destination Port"
54121,443,54121,443,allow,184574,24037,160537,209,84,87,122,1,"High deviation in pkts_sent, Bytes Received, Bytes"
54114,443,54114,443,allow,171467,27550,143917,220,85,108,112,1,"High deviation in pkts_sent, Bytes Received, Bytes"
54122,443,54122,443,allow,186718,24971,161747,253,84,127,126,1,"High deviation in pkts_sent, Bytes Received, Bytes"
55431,443,58607,443,allow,999955,25445,974510,1003,171,325,678,1,"High deviation in pkts_sent, Bytes Received, Bytes"
39446,443,32219,443,allow,1647482,62713,1584769,1898,219,744,1154,1,"High deviation in pkts_sent, Bytes Received, Bytes"
62724,443,47821,443,allow,87797,47766,40031,754,453,303,451,1,"High deviation in pkts_sent, Bytes Sent, Bytes"
55429,443,27216,443,allow,343735,15691,328044,423,171,179,244,1,"High deviation in pkts_sent, Bytes Received, Bytes"
37965,4546,34269,4546,allow,3957,2324,1633,51,1720,29,22,1,"High deviation in pkts_sent, Elapsed Time (sec), Bytes Sent"
52410,443,38111,443,allow,128802,48896,79906,237,24,121,116,1,"High deviation in pkts_sent, Bytes Sent, Bytes"
55428,443,63993,443,allow,74784,4781,70003,122,171,55,67,1,"High deviation in pkts_sent, Bytes Received, Bytes"
54123,443,54123,443,allow,79652,20710,58942,112,84,58,54,1,"High deviation in pkts_sent, Bytes Sent, Bytes"
55430,443,62629,443,allow,805321,15163,790158,752,171,204,548,1,"High deviation in pkts_sent, Bytes Received, Bytes"
51518,443,15866,443,allow,38155,33545,4610,79,26,42,37,1,"High deviation in pkts_sent, Bytes Sent, Bytes"
53630,64745,62898,64745,allow,70,70,0,2,7,2,0,1,"High deviation in pkts_sent, NAT Destination Port, Destination Port"
45563,443,24709,443,allow,1022491,42917,979574,1099,36,416,683,1,"High deviation in pkts_sent, Bytes Received, Bytes"
50265,37083,2868,37083,allow,490,150,340,2,1200,1,1,1,"High deviation in NAT Destination Port, Destination Port, Elapsed Time (sec)"
50447,80,50342,80,allow,67694,29654,38040,85,37,40,45,1,"High deviation in pkts_sent, Bytes Sent, Bytes"
17750,58572,62694,58572,allow,150,150,0,1,1200,1,0,1,"High deviation in NAT Destination Port, Destination Port, Elapsed Time (sec)"
57470,27232,13855,27232,allow,4212,2724,1488,57,2411,33,24,1,"High deviation in pkts_sent, NAT Destination Port, Elapsed Time (sec)"
56599,443,36954,443,allow,348780,9144,339636,358,32,123,235,1,"High deviation in pkts_sent, Bytes Received, Bytes"
27005,52013,29857,52013,allow,252,252,0,3,32,3,0,1,"High deviation in pkts_sent, NAT Destination Port, Destination Port"
53011,80,53011,80,allow,349769,6527,343242,368,22,100,268,1,"High deviation in pkts_sent, Bytes Received, Bytes"
59830,443,59830,443,allow,21205,1711,19494,32,1806,11,21,1,"High deviation in pkts_sent, Bytes Received, Bytes"
47257,443,58413,443,allow,64727,10981,53746,91,141,36,55,1,"High deviation in pkts_sent, Bytes Received, Bytes"
57470,44667,49855,44667,allow,480,149,331,2,1200,1,1,1,"High deviation in NAT Destination Port, Destination Port, Elapsed Time (sec)"
60405,64722,55660,64722,allow,70,70,0,1,5,1,0,1,"High deviation in NAT Destination Port, Destination Port, NAT Source Port"
59766,443,36182,443,allow,508206,39212,468994,748,192,296,452,1,"High deviation in pkts_sent, Bytes Received, Bytes"
42744,443,24894,443,allow,224178,118713,105465,333,140,162,171,1,"High deviation in pkts_sent, Bytes Sent, Bytes"
37965,47686,60898,47686,allow,480,149,331,2,1200,1,1,1,"High deviation in NAT Destination Port, Destination Port, Elapsed Time (sec)"
60406,64337,21894,64337,allow,70,70,0,1,5,1,0,1,"High deviation in NAT Destination Port, Destination Port, NAT Source Port"
35670,443,58907,443,allow,295458,11828,283630,339,185,137,202,1,"High deviation in pkts_sent, Bytes Received, Bytes"
55708,443,3177,443,allow,10710,4573,6137,53,3376,31,22,1,"High deviation in pkts_sent, Elapsed Time (sec), Bytes Sent"
51795,60258,28772,60258,allow,70,70,0,1,5,1,0,1,"High deviation in NAT Destination Port, Destination Port, NAT Source Port"
37965,54371,6962,54371,allow,132,132,0,3,1199,3,0,1,"High deviation in pkts_sent, NAT Destination Port, Destination Port"
51654,80,36290,80,allow,170875,6864,164011,255,35,93,162,1,"High deviation in pkts_sent, Bytes Received, Bytes"
65474,443,34045,443,allow,355358,10960,344398,369,16,131,238,1,"High deviation in pkts_sent, Bytes Received, Bytes"
51221,47391,14393,47391,allow,323,150,173,2,1203,1,1,1,"High deviation in NAT Destination Port, Destination Port, Elapsed Time (sec)"
63585,443,56391,443,allow,123421,11745,111676,267,125,108,159,1,"High deviation in pkts_sent, Bytes Received, Bytes"
63571,443,39273,443,allow,1882441,60775,1821666,2129,129,795,1334,1,"High deviation in pkts_sent, Bytes Received, Bytes"
53622,61393,55834,61393,allow,320,140,180,6,7,3,3,1,"High deviation in pkts_sent, NAT Destination Port, Destination Port"
55689,443,55689,443,allow,177498,9805,167693,244,80,119,125,1,"High deviation in pkts_sent, Bytes Received, Bytes"
35055,80,30586,80,allow,3650999,83941,3567058,3541,21,1184,2357,1,"High deviation in pkts_sent, Bytes Received, Bytes"
55688,443,55688,443,allow,115875,6637,109238,158,80,71,87,1,"High deviation in pkts_sent, Bytes Received, Bytes"
57925,443,19196,443,allow,43126,33414,9712,214,220,108,106,1,"High deviation in pkts_sent, Bytes Sent, Bytes"
48817,61613,48817,61613,allow,490,149,341,2,1200,1,1,1,"High deviation in NAT Destination Port, Destination Port, Elapsed Time (sec)"
65473,443,51323,443,allow,91831,4379,87452,101,15,37,64,1,"High deviation in pkts_sent, Bytes Received, Bytes"
58415,443,47391,443,allow,145249,142210,3039,143,185,106,37,1,"High deviation in pkts_sent, Bytes Sent, Bytes"
64753,443,41377,443,allow,145226,5591,139635,164,120,58,106,1,"High deviation in pkts_sent, Bytes Received, Bytes"
57952,443,57780,443,allow,480591,8786,471805,442,46,102,340,1,"High deviation in pkts_sent, Bytes Received, Bytes"
56739,443,56739,443,allow,94524,4465,90059,126,45,56,70,1,"High deviation in pkts_sent, Bytes Received, Bytes"
60308,443,63284,443,allow,2622412,144918,2477494,3052,316,1078,1974,1,"High deviation in pkts_sent, Bytes Received, Bytes"
15503,36501,26789,36501,allow,323,150,173,2,1201,1,1,1,"High deviation in NAT Destination Port, Destination Port, Elapsed Time (sec)"
49720,443,3612,443,allow,180777,5704,175073,204,105,67,137,1,"High deviation in pkts_sent, Bytes Received, Bytes"
63796,60557,39305,60557,allow,66,66,0,2,8,2,0,1,"High deviation in pkts_sent, NAT Destination Port, Destination Port"
62731,443,8633,443,allow,27905,17646,10259,131,308,73,58,1,"High deviation in pkts_sent, Bytes Sent, Bytes"
49725,443,10242,443,allow,311104,8270,302834,336,18,99,237,1,"High deviation in pkts_sent, Bytes Received, Bytes"
53010,80,53010,80,allow,210304,4398,205906,225,21,65,160,1,"High deviation in pkts_sent, Bytes Received, Bytes"
60411,58131,51349,58131,allow,70,70,0,2,8,2,0,1,"High deviation in pkts_sent, NAT Destination Port, Destination Port"
49719,443,56556,443,allow,560073,155518,404555,923,110,411,512,1,"High deviation in pkts_sent, Bytes Sent, Bytes"
50213,80,50213,80,allow,1723391,21750,1701641,1450,16,326,1124,1,"High deviation in pkts_sent, Bytes Received, Bytes"
45658,443,10440,443,allow,5359,3152,2207,51,2901,28,23,1,"High deviation in pkts_sent, Elapsed Time (sec), Bytes Sent"
34758,5228,2453,5228,allow,10206,2218,7988,36,4265,18,18,1,"High deviation in pkts_sent, Elapsed Time (sec), Bytes Received"
51438,443,45079,443,allow,42419,28515,13904,108,246,53,55,1,"High deviation in pkts_sent, Bytes Sent, Bytes"
54983,443,42126,443,allow,865636,22536,843100,903,50,309,594,1,"High deviation in pkts_sent, Bytes Received, Bytes"
58446,443,26245,443,allow,111535,9830,101705,141,192,62,79,1,"High deviation in pkts_sent, Bytes Received, Bytes"
51516,443,51516,443,allow,143921,6996,136925,152,174,42,110,1,"High deviation in pkts_sent, Bytes Received, Bytes"
53611,58508,47899,58508,allow,320,140,180,6,7,3,3,1,"High deviation in pkts_sent, NAT Destination Port, Destination Port"
34756,443,27102,443,allow,100090,8304,91786,135,127,50,85,1,"High deviation in pkts_sent, Bytes Received, Bytes"
30960,45694,42221,45694,allow,330,330,0,6,3610,6,0,1,"High deviation in pkts_sent, NAT Destination Port, Elapsed Time (sec)"
57470,61803,17706,61803,allow,792,792,0,13,1200,13,0,1,"High deviation in pkts_sent, NAT Destination Port, Destination Port"
10151,55051,56267,55051,allow,468,149,319,2,1200,1,1,1,"High deviation in NAT Destination Port, Destination Port, Elapsed Time (sec)"
65234,5228,52749,5228,allow,4149,2263,1886,46,708,23,23,1,"High deviation in pkts_sent, NAT Destination Port, Bytes Sent"
6881,33969,15980,33969,allow,509,150,359,2,1200,1,1,1,"High deviation in NAT Destination Port, Destination Port, Elapsed Time (sec)"
51521,443,51521,443,allow,138679,4142,134537,141,173,33,108,1,"High deviation in pkts_sent, Bytes Received, Bytes"
60403,60092,40292,60092,allow,70,70,0,1,5,1,0,1,"High deviation in NAT Destination Port, Destination Port, NAT Source Port"
54979,443,32141,443,allow,643217,29500,613717,787,53,338,449,1,"High deviation in pkts_sent, Bytes Received, Bytes"
61167,443,24525,443,allow,27000,11646,15354,176,640,82,94,1,"High deviation in pkts_sent, Bytes Sent, Bytes"
27005,52013,16949,52013,allow,901,126,775,2,30,1,1,1,"High deviation in NAT Destination Port, Destination Port, Bytes Received"
53586,44515,38182,44515,allow,678,432,246,10,15,6,4,1,"High deviation in pkts_sent, NAT Destination Port, Destination Port"
44125,5222,56837,5222,allow,6329,3447,2882,67,841,34,33,1,"High deviation in pkts_sent, Bytes Sent, NAT Destination Port"
51517,443,51517,443,allow,153968,7663,146305,170,173,43,127,1,"High deviation in pkts_sent, Bytes Received, Bytes"
53585,43611,54963,43611,allow,612,306,306,10,15,5,5,1,"High deviation in pkts_sent, NAT Destination Port, Destination Port"
51648,80,37574,80,allow,974005,25912,948093,1003,32,361,642,1,"High deviation in pkts_sent, Bytes Received, Bytes"
34527,443,29221,443,allow,480624,56231,424393,860,196,427,433,1,"High deviation in pkts_sent, Bytes Received, Bytes"
49815,443,13935,443,allow,8614049,176366,8437683,7757,202,1608,6149,1,"High deviation in pkts_sent, Bytes Received, Bytes"
62470,443,10717,443,allow,38402253,1191239,37211014,39088,243,12126,26962,1,"High deviation in pkts_sent, Bytes Received, Bytes"
57470,41315,64435,41315,allow,792,792,0,13,1199,13,0,1,"High deviation in pkts_sent, NAT Destination Port, Destination Port"
6881,12388,2664,12388,allow,216,118,98,2,1199,1,1,1,"High deviation in NAT Destination Port, Elapsed Time (sec), Destination Port"
34873,443,26122,443,allow,236097,12185,223912,307,32,125,182,1,"High deviation in pkts_sent, Bytes Received, Bytes"
36793,80,35918,80,allow,156726,8626,148100,206,32,104,102,1,"High deviation in pkts_sent, Bytes Received, Bytes"
36789,80,36658,80,allow,129896,7448,122448,172,32,87,85,1,"High deviation in pkts_sent, Bytes Received, Bytes"
36792,80,39617,80,allow,152694,8416,144278,200,32,101,99,1,"High deviation in pkts_sent, Bytes Received, Bytes"
43600,443,57317,443,allow,172272,14401,157871,254,418,100,154,1,"High deviation in pkts_sent, Bytes Received, Bytes"
33570,443,59571,443,allow,81954,13611,68343,174,34,79,95,1,"High deviation in pkts_sent, Bytes Received, Bytes"
59312,443,40068,443,allow,233778,8502,225276,276,34,109,167,1,"High deviation in pkts_sent, Bytes Received, Bytes"
57022,80,30750,80,allow,77115,5003,72112,110,35,56,54,1,"High deviation in pkts_sent, Bytes Received, Bytes"
33576,443,52498,443,allow,170319,23354,146965,283,34,121,162,1,"High deviation in pkts_sent, Bytes Received, Bytes"
36790,80,59682,80,allow,191737,8302,183435,205,31,79,126,1,"High deviation in pkts_sent, Bytes Received, Bytes"
49672,80,61052,80,allow,3874260,98179,3776081,4003,1072,1479,2524,1,"High deviation in pkts_sent, Bytes Received, Bytes"
36791,80,9992,80,allow,196328,10952,185376,244,31,117,127,1,"High deviation in pkts_sent, Bytes Received, Bytes"
43675,80,34710,80,allow,1676620,41953,1634667,1725,25,636,1089,1,"High deviation in pkts_sent, Bytes Received, Bytes"
56543,443,26469,443,allow,245527,10641,234886,322,405,136,186,1,"High deviation in pkts_sent, Bytes Received, Bytes"
51800,63796,36885,63796,allow,70,70,0,2,8,2,0,1,"High deviation in pkts_sent, NAT Destination Port, Destination Port"
53119,58118,15448,58118,allow,70,70,0,2,8,2,0,1,"High deviation in pkts_sent, NAT Destination Port, Destination Port"
59574,443,1442,443,allow,2582500,86854,2495646,2678,84,986,1692,1,"High deviation in pkts_sent, Bytes Received, Bytes"
36788,80,9413,80,allow,235873,12126,223747,306,31,154,152,1,"High deviation in pkts_sent, Bytes Received, Bytes"
41421,443,56908,443,allow,168930,11361,157569,252,31,101,151,1,"High deviation in pkts_sent, Bytes Received, Bytes"
55347,443,1685,443,allow,116686,21822,94864,224,186,112,112,1,"High deviation in pkts_sent, Bytes Received, Bytes"
62783,443,22003,443,allow,28847,16957,11890,144,293,60,84,1,"High deviation in pkts_sent, Bytes Sent, Bytes"
61151,443,65420,443,allow,121129,5559,115570,157,640,51,106,1,"High deviation in pkts_sent, Bytes Received, Bytes"
53579,59332,61782,59332,allow,70,70,0,1,5,1,0,1,"High deviation in NAT Destination Port, Destination Port, NAT Source Port"
53584,62974,57251,62974,allow,70,70,0,1,5,1,0,1,"High deviation in NAT Destination Port, Destination Port, NAT Source Port"
11295,40002,59394,40002,allow,209,85,124,4,34,2,2,1,"High deviation in pkts_sent, NAT Destination Port, Destination Port"
6882,43825,33329,43825,allow,200,111,89,2,1200,1,1,1,"High deviation in NAT Destination Port, Destination Port, Elapsed Time (sec)"
50265,45599,34078,45599,allow,330,330,0,6,1200,6,0,1,"High deviation in pkts_sent, NAT Destination Port, Destination Port"
65376,443,34209,443,allow,55500,40540,14960,137,131,72,65,1,"High deviation in pkts_sent, Bytes Sent, Bytes"
37965,32305,6845,32305,allow,1650,1650,0,26,1537,26,0,1,"High deviation in pkts_sent, NAT Destination Port, Elapsed Time (sec)"
53606,54476,23615,54476,allow,320,140,180,6,6,3,3,1,"High deviation in pkts_sent, NAT Destination Port, Destination Port"
51646,80,63912,80,allow,1038219,43977,994242,1734,30,616,1118,1,"High deviation in pkts_sent, Bytes Received, Bytes"
51467,443,43898,443,allow,186117,12962,173155,249,143,83,166,1,"High deviation in pkts_sent, Bytes Received, Bytes"
65472,443,58915,443,allow,460338,13340,446998,472,16,165,307,1,"High deviation in pkts_sent, Bytes Received, Bytes"
49650,443,63033,443,allow,93063,2948,90115,107,80,30,77,1,"High deviation in pkts_sent, Bytes Received, Bytes"
54980,443,53564,443,allow,1541965,48559,1493406,1663,51,623,1040,1,"High deviation in pkts_sent, Bytes Received, Bytes"
50265,57121,42011,57121,allow,132,132,0,3,1200,3,0,1,"High deviation in pkts_sent, NAT Destination Port, Destination Port"
51778,60565,33068,60565,allow,70,70,0,1,5,1,0,1,"High deviation in NAT Destination Port, Destination Port, NAT Source Port"
21133,27613,37990,27613,allow,481,150,331,2,1199,1,1,1,"High deviation in NAT Destination Port, Elapsed Time (sec), Destination Port"
57470,48096,60784,48096,allow,132,132,0,3,1200,3,0,1,"High deviation in pkts_sent, NAT Destination Port, Destination Port"
57470,44822,45311,44822,allow,132,132,0,3,1200,3,0,1,"High deviation in pkts_sent, NAT Destination Port, Destination Port"
34351,443,4638,443,allow,402051,17714,384337,520,83,228,292,1,"High deviation in pkts_sent, Bytes Received, Bytes"
50904,80,18118,80,allow,12289218,202774,12086444,11470,149,2789,8681,1,"High deviation in pkts_sent, Bytes Received, Bytes"
47080,80,47080,80,allow,276453,7832,268621,287,165,92,195,1,"High deviation in pkts_sent, Bytes Received, Bytes"
58283,443,44449,443,allow,42792,12402,30390,98,370,45,53,1,"High deviation in pkts_sent, Bytes Sent, Bytes"
51799,58416,38209,58416,allow,316,136,180,6,6,3,3,1,"High deviation in pkts_sent, NAT Destination Port, Destination Port"
51775,57887,37993,57887,allow,66,66,0,1,5,1,0,1,"High deviation in NAT Destination Port, Destination Port, NAT Source Port"
60405,64722,47645,64722,allow,70,70,0,2,8,2,0,1,"High deviation in pkts_sent, NAT Destination Port, Destination Port"
65471,443,32170,443,allow,92569,4939,87630,111,15,45,66,1,"High deviation in pkts_sent, Bytes Received, Bytes"
55613,56511,52356,56511,allow,504,318,186,8,15,5,3,1,"High deviation in pkts_sent, NAT Destination Port, Destination Port"
52957,80,46330,80,allow,156378,5406,150972,165,383,60,105,1,"High deviation in pkts_sent, Bytes Received, Bytes"
51505,443,46771,443,allow,645662,22326,623336,743,41,299,444,1,"High deviation in pkts_sent, Bytes Received, Bytes"
60406,64337,47861,64337,allow,70,70,0,2,8,2,0,1,"High deviation in pkts_sent, NAT Destination Port, Destination Port"
46762,443,18994,443,allow,565251,13665,551586,542,30,173,369,1,"High deviation in pkts_sent, Bytes Received, Bytes"
52732,80,5693,80,allow,23509,14666,8843,70,553,38,32,1,"High deviation in pkts_sent, Bytes Sent, Bytes"
55611,58049,54667,58049,allow,504,318,186,8,15,5,3,1,"High deviation in pkts_sent, NAT Destination Port, Destination Port"
51795,60258,12488,60258,allow,70,70,0,2,8,2,0,1,"High deviation in pkts_sent, NAT Destination Port, Destination Port"
50265,55243,25034,55243,allow,481,150,331,2,1200,1,1,1,"High deviation in NAT Destination Port, Destination Port, Elapsed Time (sec)"
59974,443,48312,443,allow,200862,57949,142913,361,24,172,189,1,"High deviation in pkts_sent, Bytes Sent, Bytes"
59980,443,52666,443,allow,345468,18536,326932,432,22,200,232,1,"High deviation in pkts_sent, Bytes Received, Bytes"
52763,443,13803,443,allow,256711,14141,242570,367,96,152,215,1,"High deviation in pkts_sent, Bytes Received, Bytes"
61467,443,56685,443,allow,130792,4916,125876,161,89,69,92,1,"High deviation in pkts_sent, Bytes Received, Bytes"
50564,443,64623,443,allow,1894028,31411,1862617,1579,122,209,1370,1,"High deviation in pkts_sent, Bytes Received, Bytes"
30960,45692,4911,45692,allow,330,330,0,6,3609,6,0,1,"High deviation in pkts_sent, NAT Destination Port, Elapsed Time (sec)"
49432,5228,59843,5228,allow,10635,3087,7548,41,3661,22,19,1,"High deviation in pkts_sent, Elapsed Time (sec), Bytes Sent"
59981,443,57380,443,allow,180817,9921,170896,241,21,116,125,1,"High deviation in pkts_sent, Bytes Received, Bytes"
49176,443,60169,443,allow,533295,14310,518985,552,18,201,351,1,"High deviation in pkts_sent, Bytes Received, Bytes"
58557,443,4317,443,allow,114852,43911,70941,248,69,132,116,1,"High deviation in pkts_sent, Bytes Sent, Bytes"
61833,443,61833,443,allow,80743,4724,76019,101,89,37,64,1,"High deviation in pkts_sent, Bytes Received, Bytes"
43677,443,54935,443,allow,30090,19982,10108,77,543,41,36,1,"High deviation in pkts_sent, Bytes Sent, Bytes"
37697,443,26341,443,allow,2071929,56793,2015136,2088,179,685,1403,1,"High deviation in pkts_sent, Bytes Received, Bytes"
42599,443,19054,443,allow,215284,28807,186477,346,129,151,195,1,"High deviation in pkts_sent, Bytes Received, Bytes"
46695,443,28304,443,allow,12787534,288179,12499355,12299,64,4036,8263,1,"High deviation in pkts_sent, Bytes Received, Bytes"
59983,443,57676,443,allow,158230,9208,149022,214,21,105,109,1,"High deviation in pkts_sent, Bytes Received, Bytes"
39570,443,58125,443,allow,127970,4968,123002,144,30,53,91,1,"High deviation in pkts_sent, Bytes Received, Bytes"
49163,36069,48102,36069,allow,5990,5698,292,17,51,14,3,1,"High deviation in pkts_sent, NAT Destination Port, Bytes Sent"
39571,443,44587,443,allow,580560,15724,564836,583,30,187,396,1,"High deviation in pkts_sent, Bytes Received, Bytes"
39569,443,5001,443,allow,1784075,46752,1737323,1812,47,606,1206,1,"High deviation in pkts_sent, Bytes Received, Bytes"
6881,37957,48141,37957,allow,509,150,359,2,1199,1,1,1,"High deviation in NAT Destination Port, Destination Port, Elapsed Time (sec)"
50905,80,47395,80,allow,11749346,149441,11599905,10089,147,2116,7973,1,"High deviation in pkts_sent, Bytes Received, Bytes"
2080,7000,2080,7000,allow,754151,15395,738756,762,16,239,523,1,"High deviation in pkts_sent, Bytes Received, Bytes"
6881,35766,64668,35766,allow,221,111,110,2,1200,1,1,1,"High deviation in NAT Destination Port, Destination Port, Elapsed Time (sec)"
55594,42459,54770,42459,allow,1253,716,537,12,23,7,5,1,"High deviation in pkts_sent, NAT Destination Port, Destination Port"
6881,6881,55325,6881,allow,853,355,498,4,1200,2,2,1,"High deviation in pkts_sent, NAT Destination Port, Elapsed Time (sec)"
30960,45691,5004,45691,allow,330,330,0,6,3609,6,0,1,"High deviation in pkts_sent, NAT Destination Port, Elapsed Time (sec)"
49349,80,23734,80,allow,185645,6753,178892,213,81,89,124,1,"High deviation in pkts_sent, Bytes Received, Bytes"
55601,44049,44869,44049,allow,504,318,186,8,15,5,3,1,"High deviation in pkts_sent, NAT Destination Port, Destination Port"
55604,44235,60786,44235,allow,504,318,186,8,15,5,3,1,"High deviation in pkts_sent, NAT Destination Port, Destination Port"
35371,443,55003,443,allow,304294,8535,295759,302,132,90,212,1,"High deviation in pkts_sent, Bytes Received, Bytes"
57470,51413,20990,51413,allow,132,132,0,3,1199,3,0,1,"High deviation in pkts_sent, NAT Destination Port, Destination Port"
57470,32554,26489,32554,allow,726,726,0,12,1199,12,0,1,"High deviation in pkts_sent, NAT Destination Port, Destination Port"
55877,51413,55340,51413,allow,460,150,310,2,1200,1,1,1,"High deviation in NAT Destination Port, Destination Port, Elapsed Time (sec)"
51221,20864,10145,20864,allow,7308,6812,496,71,3243,63,8,1,"High deviation in pkts_sent, NAT Destination Port, Bytes Sent"
51768,61765,15043,61765,allow,66,66,0,1,5,1,0,1,"High deviation in NAT Destination Port, Destination Port, Bytes"
53035,5228,40515,5228,allow,2725,1610,1115,20,3600,10,10,1,"High deviation in pkts_sent, Elapsed Time (sec), NAT Destination Port"
30960,45690,12118,45690,allow,330,330,0,6,3609,6,0,1,"High deviation in pkts_sent, NAT Destination Port, Elapsed Time (sec)"
30960,45689,37422,45689,allow,330,330,0,6,3609,6,0,1,"High deviation in pkts_sent, NAT Destination Port, Elapsed Time (sec)"
61041,443,15332,443,allow,77650,64697,12953,148,902,81,67,1,"High deviation in pkts_sent, Bytes Sent, Bytes"
53596,56732,58606,56732,allow,70,70,0,2,7,2,0,1,"High deviation in pkts_sent, NAT Destination Port, Destination Port"
60403,60092,47131,60092,allow,70,70,0,2,8,2,0,1,"High deviation in pkts_sent, NAT Destination Port, Destination Port"
51767,59158,56330,59158,allow,70,70,0,1,5,1,0,1,"High deviation in NAT Destination Port, Destination Port, NAT Source Port"
52121,443,41012,443,allow,199757,7497,192260,216,45,80,136,1,"High deviation in pkts_sent, Bytes Received, Bytes"
55002,443,31651,443,allow,469783,461079,8704,444,167,329,115,1,"High deviation in pkts_sent, Bytes Sent, Bytes"
41440,5228,57433,5228,allow,8866,2015,6851,29,4793,14,15,1,"High deviation in pkts_sent, Elapsed Time (sec), NAT Destination Port"
57470,61768,42520,61768,allow,330,330,0,6,1199,6,0,1,"High deviation in pkts_sent, NAT Destination Port, Destination Port"
6882,6881,62031,6881,allow,238,118,120,2,1200,1,1,1,"High deviation in NAT Destination Port, Elapsed Time (sec), Destination Port"
15503,26886,1778,26886,allow,481,150,331,2,1200,1,1,1,"High deviation in NAT Destination Port, Elapsed Time (sec), Destination Port"
21087,80,21087,80,allow,159790,4676,155114,177,128,67,110,1,"High deviation in pkts_sent, Bytes Received, Bytes"
51221,51413,20920,51413,allow,459,149,310,2,1200,1,1,1,"High deviation in NAT Destination Port, Destination Port, Elapsed Time (sec)"
50584,11830,62858,11830,allow,2118,900,1218,14,4232,7,7,1,"High deviation in pkts_sent, Elapsed Time (sec), NAT Destination Port"
10151,19083,54566,19083,allow,489,149,340,2,1200,1,1,1,"High deviation in NAT Destination Port, Elapsed Time (sec), Destination Port"
55052,80,37545,80,allow,11677266,314362,11362904,12711,129,5174,7537,1,"High deviation in pkts_sent, Bytes Received, Bytes"
49919,80,50897,80,allow,2821387,64706,2756681,2277,183,418,1859,1,"High deviation in pkts_sent, Bytes Received, Bytes"
52120,443,51831,443,allow,305183,9715,295468,312,44,107,205,1,"High deviation in pkts_sent, Bytes Received, Bytes"
63067,443,13404,443,allow,2570995,60656,2510339,2538,34,844,1694,1,"High deviation in pkts_sent, Bytes Received, Bytes"
34529,443,32303,443,allow,77395,64623,12772,206,188,116,90,1,"High deviation in pkts_sent, Bytes Sent, Bytes"
60402,47094,53695,47094,allow,320,140,180,6,7,3,3,1,"High deviation in pkts_sent, NAT Destination Port, Destination Port"
65470,443,40363,443,allow,372361,11310,361051,385,16,136,249,1,"High deviation in pkts_sent, Bytes Received, Bytes"
46159,443,12485,443,allow,124567,6787,117780,175,263,82,93,1,"High deviation in pkts_sent, Bytes Received, Bytes"
30188,14432,60719,14432,allow,868,150,718,4,1200,2,2,1,"High deviation in pkts_sent, NAT Destination Port, Elapsed Time (sec)"
50455,443,11561,443,allow,107749,6262,101487,142,138,58,84,1,"High deviation in pkts_sent, Bytes Received, Bytes"
64413,443,46827,443,allow,5660875,75934,5584941,4719,141,686,4033,1,"High deviation in pkts_sent, Bytes Received, Bytes"
52251,443,26101,443,allow,23328780,730794,22597986,24754,320,8113,16641,1,"High deviation in pkts_sent, Bytes Received, Bytes"
8861,443,39985,443,allow,42890,30849,12041,214,420,106,108,1,"High deviation in pkts_sent, Bytes Sent, Bytes"
43368,80,43368,80,allow,232198,9152,223046,290,21,134,156,1,"High deviation in pkts_sent, Bytes Received, Bytes"
53584,62974,25990,62974,allow,70,70,0,2,8,2,0,1,"High deviation in pkts_sent, NAT Destination Port, Destination Port"
53564,63344,20702,63344,allow,1721,971,750,15,16,8,7,1,"High deviation in pkts_sent, NAT Destination Port, Destination Port"
43597,443,44647,443,allow,47048,9293,37755,63,412,28,35,1,"High deviation in pkts_sent, Bytes Received, Bytes"
57877,443,6198,443,allow,9256443,112898,9143545,7609,178,1428,6181,1,"High deviation in pkts_sent, Bytes Received, Bytes"
53579,59332,37605,59332,allow,70,70,0,2,8,2,0,1,"High deviation in pkts_sent, NAT Destination Port, Destination Port"
43472,5228,13384,5228,allow,2531,1416,1115,17,3600,8,9,1,"High deviation in pkts_sent, Elapsed Time (sec), NAT Destination Port"
25629,28678,25311,28678,allow,1806,1806,0,22,225,22,0,1,"High deviation in pkts_sent, NAT Destination Port, Destination Port"
57898,443,41076,443,allow,240332,6623,233709,258,170,92,166,1,"High deviation in pkts_sent, Bytes Received, Bytes"
41689,443,36583,443,allow,1307513,51701,1255812,1486,148,576,910,1,"High deviation in pkts_sent, Bytes Received, Bytes"
51512,443,52808,443,allow,626132,21332,604800,730,33,294,436,1,"High deviation in pkts_sent, Bytes Received, Bytes"
37695,443,3343,443,allow,1134364,30994,1103370,1170,175,403,767,1,"High deviation in pkts_sent, Bytes Received, Bytes"
51506,443,52823,443,allow,584947,21842,563105,678,36,286,392,1,"High deviation in pkts_sent, Bytes Received, Bytes"
57872,443,43316,443,allow,183325,10358,172967,289,227,95,194,1,"High deviation in pkts_sent, Bytes Received, Bytes"
50831,443,11343,443,allow,721741,131746,589995,1518,322,787,731,1,"High deviation in pkts_sent, Bytes Received, Bytes"
41700,443,15367,443,allow,167721,6935,160786,185,77,68,117,1,"High deviation in pkts_sent, Bytes Received, Bytes"
53036,443,40328,443,allow,249145,4184,244961,218,107,40,178,1,"High deviation in pkts_sent, Bytes Received, Bytes"
57888,443,55452,443,allow,113115,8327,104788,184,177,77,107,1,"High deviation in pkts_sent, Bytes Received, Bytes"
41674,443,45032,443,allow,14424911,433341,13991570,15454,320,5482,9972,1,"High deviation in pkts_sent, Bytes Received, Bytes"
53240,443,16717,443,allow,1296713,27754,1268959,1253,118,366,887,1,"High deviation in pkts_sent, Bytes Received, Bytes"
45871,443,58048,443,allow,275011,235921,39090,651,350,363,288,1,"High deviation in pkts_sent, Bytes Sent, Bytes"
51507,443,1531,443,allow,584465,23057,561408,694,36,303,391,1,"High deviation in pkts_sent, Bytes Received, Bytes"
51511,443,55401,443,allow,213140,10321,202819,260,33,108,152,1,"High deviation in pkts_sent, Bytes Received, Bytes"
65469,443,41637,443,allow,92958,4869,88089,109,15,44,65,1,"High deviation in pkts_sent, Bytes Received, Bytes"
49345,443,4175,443,allow,61954,10029,51925,114,82,50,64,1,"High deviation in pkts_sent, Bytes Received, Bytes"
51778,60565,25061,60565,allow,70,70,0,2,8,2,0,1,"High deviation in pkts_sent, NAT Destination Port, Destination Port"
41690,443,19019,443,allow,1478937,62961,1415976,1678,148,649,1029,1,"High deviation in pkts_sent, Bytes Received, Bytes"
19473,32332,63968,32332,allow,481,150,331,2,1200,1,1,1,"High deviation in NAT Destination Port, Destination Port, Elapsed Time (sec)"
44076,443,35127,443,allow,202384,47621,154763,307,198,112,195,1,"High deviation in pkts_sent, Bytes, Bytes Sent"
15503,37512,24044,37512,allow,528,528,0,9,1199,9,0,1,"High deviation in pkts_sent, NAT Destination Port, Destination Port"
45373,443,33904,443,allow,33357,26315,7042,65,273,38,27,1,"High deviation in pkts_sent, Bytes Sent, Bytes"
51775,57887,60310,57887,allow,70,70,0,2,8,2,0,1,"High deviation in pkts_sent, NAT Destination Port, Destination Port"
62864,443,56821,443,allow,86513,10300,76213,131,137,54,77,1,"High deviation in pkts_sent, Bytes Received, Bytes"
21133,26760,14164,26760,allow,480,149,331,2,1200,1,1,1,"High deviation in NAT Destination Port, Elapsed Time (sec), Destination Port"
49896,443,39739,443,allow,151170,17408,133762,256,130,118,138,1,"High deviation in pkts_sent, Bytes Received, Bytes"
65091,80,65091,80,allow,18499242,314733,18184509,19253,37,4700,14553,1,"High deviation in pkts_sent, Bytes Received, Bytes"
63759,64509,61744,64509,allow,70,70,0,1,4,1,0,1,"High deviation in NAT Destination Port, Destination Port, NAT Source Port"
51158,443,53566,443,allow,3155111,84086,3071025,3163,75,1072,2091,1,"High deviation in pkts_sent, Bytes Received, Bytes"
37965,16153,40075,16153,allow,1320,1320,0,21,1682,21,0,1,"High deviation in pkts_sent, NAT Destination Port, Elapsed Time (sec)"
61146,443,19937,443,allow,8580941,269463,8311478,9202,122,3016,6186,1,"High deviation in pkts_sent, Bytes Received, Bytes"
37965,48782,19115,48782,allow,132,132,0,3,1199,3,0,1,"High deviation in pkts_sent, NAT Destination Port, Destination Port"
57051,443,6628,443,allow,594793,518081,76712,1350,1004,781,569,1,"High deviation in pkts_sent, Bytes Sent, Bytes"
51772,59814,12241,59814,allow,70,70,0,2,8,2,0,1,"High deviation in pkts_sent, NAT Destination Port, Destination Port"
59948,443,41928,443,allow,349197,16542,332655,411,129,150,261,1,"High deviation in pkts_sent, Bytes Received, Bytes"
50265,41071,33048,41071,allow,1716,1716,0,27,2188,27,0,1,"High deviation in pkts_sent, NAT Destination Port, Elapsed Time (sec)"
34734,443,41689,443,allow,7974,2716,5258,50,7261,26,24,1,"High deviation in pkts_sent, Elapsed Time (sec), Bytes Sent"
54836,443,5754,443,allow,119863,100823,19040,322,229,183,139,1,"High deviation in pkts_sent, Bytes Sent, Bytes"
46451,443,47700,443,allow,350492,17722,332770,449,125,169,280,1,"High deviation in pkts_sent, Bytes Received, Bytes"
37694,443,63637,443,allow,234688,15158,219530,324,173,157,167,1,"High deviation in pkts_sent, Bytes Received, Bytes"
51715,443,35378,443,allow,4175264,89546,4085718,4141,532,1111,3030,1,"High deviation in pkts_sent, Bytes Received, Bytes"
50885,80,41376,80,allow,291594,13131,278463,312,159,116,196,1,"High deviation in pkts_sent, Bytes Received, Bytes"
52404,443,21006,443,allow,132575,6675,125900,206,94,91,115,1,"High deviation in pkts_sent, Bytes Received, Bytes"
6881,30096,6963,30096,allow,509,150,359,2,1199,1,1,1,"High deviation in NAT Destination Port, Elapsed Time (sec), Destination Port"
6881,20326,20950,20326,allow,509,150,359,2,1200,1,1,1,"High deviation in NAT Destination Port, Elapsed Time (sec), Destination Port"
56279,443,57070,443,allow,97608,4852,92756,108,121,37,71,1,"High deviation in pkts_sent, Bytes Received, Bytes"
37965,25180,40858,25180,allow,858,858,0,14,1199,14,0,1,"High deviation in pkts_sent, NAT Destination Port, Elapsed Time (sec)"
51676,443,25301,443,allow,90135,76061,14074,251,247,132,119,1,"High deviation in pkts_sent, Bytes Sent, Bytes"
62228,443,62228,443,allow,296688,57600,239088,332,96,141,191,1,"High deviation in pkts_sent, Bytes Received, Bytes"
62229,443,62229,443,allow,211574,21152,190422,236,96,92,144,1,"High deviation in pkts_sent, Bytes Received, Bytes"
57470,55000,8797,55000,allow,726,726,0,12,1200,12,0,1,"High deviation in pkts_sent, NAT Destination Port, Destination Port"
57470,54154,42196,54154,allow,480,149,331,2,1200,1,1,1,"High deviation in NAT Destination Port, Destination Port, Elapsed Time (sec)"
51413,443,51090,443,allow,63766,32148,31618,103,42,51,52,1,"High deviation in pkts_sent, Bytes Sent, Bytes"
62230,443,62230,443,allow,119850,11021,108829,134,95,50,84,1,"High deviation in pkts_sent, Bytes Received, Bytes"
51777,63497,24893,63497,allow,316,136,180,6,6,3,3,1,"High deviation in pkts_sent, NAT Destination Port, Destination Port"
53555,57861,41718,57861,allow,492,306,186,8,15,5,3,1,"High deviation in pkts_sent, NAT Destination Port, Destination Port"
51779,3389,21341,3389,allow,62242217,4119315,58122902,123738,4772,43917,79821,1,"High deviation in pkts_sent, Bytes Received, Bytes"
45564,443,3708,443,allow,69614,5520,64094,100,21,52,48,1,"High deviation in pkts_sent, Bytes Received, Bytes"
49920,80,51045,80,allow,3649288,78688,3570600,2923,179,528,2395,1,"High deviation in pkts_sent, Bytes Received, Bytes"
60875,443,9147,443,allow,45373,35377,9996,88,72,48,40,1,"High deviation in pkts_sent, Bytes Sent, Bytes"
59717,443,16330,443,allow,303966,26201,277765,521,167,208,313,1,"High deviation in pkts_sent, Bytes Received, Bytes"
51414,443,43551,443,allow,78740,40216,38524,126,42,66,60,1,"High deviation in pkts_sent, Bytes Sent, Bytes"
62234,443,62234,443,allow,187597,6822,180775,203,92,67,136,1,"High deviation in pkts_sent, Bytes Received, Bytes"
54932,443,37338,443,allow,84306,6712,77594,156,236,58,98,1,"High deviation in pkts_sent, Bytes Received, Bytes"
37965,20926,65479,20926,allow,481,150,331,2,1199,1,1,1,"High deviation in NAT Destination Port, Elapsed Time (sec), Destination Port"
48991,80,63971,80,allow,121475,5644,115831,163,145,81,82,1,"High deviation in pkts_sent, Bytes Received, Bytes"
43227,443,48195,443,allow,460628,23936,436692,580,124,264,316,1,"High deviation in pkts_sent, Bytes Received, Bytes"
54854,443,6189,443,allow,32544,28348,4196,63,332,31,32,1,"High deviation in pkts_sent, Bytes Sent, Bytes"
50497,443,10813,443,allow,1642025,26957,1615068,1478,17,406,1072,1,"High deviation in pkts_sent, Bytes Received, Bytes"
51768,61765,18579,61765,allow,70,70,0,2,8,2,0,1,"High deviation in pkts_sent, NAT Destination Port, Destination Port"
59800,443,57363,443,allow,94202,5247,88955,115,37,41,74,1,"High deviation in pkts_sent, Bytes Received, Bytes"
63750,63343,14942,63343,allow,66,66,0,1,5,1,0,1,"High deviation in NAT Destination Port, Destination Port, Source Port"
56772,61424,62775,61424,allow,66,66,0,1,5,1,0,1,"High deviation in NAT Destination Port, Destination Port, NAT Source Port"
59725,443,1736,443,allow,89790,6036,83754,112,55,41,71,1,"High deviation in pkts_sent, Bytes Received, Bytes"
47150,9339,62687,9339,allow,179194,19657,159537,415,149,202,213,1,"High deviation in pkts_sent, Bytes Received, Bytes"
58035,80,30742,80,allow,100364,4917,95447,133,241,67,66,1,"High deviation in pkts_sent, Bytes Received, Bytes"
57614,443,56701,443,allow,25824,14215,11609,65,757,32,33,1,"High deviation in pkts_sent, Bytes Sent, Bytes"
54677,5228,25400,5228,allow,6679,2730,3949,43,4309,23,20,1,"High deviation in pkts_sent, Elapsed Time (sec), Bytes Sent"
60593,80,31498,80,allow,123436,6053,117383,165,241,83,82,1,"High deviation in pkts_sent, Bytes Received, Bytes"
50584,55727,63781,55727,allow,2268,1050,1218,15,5442,8,7,1,"High deviation in pkts_sent, NAT Destination Port, Elapsed Time (sec)"
30960,45686,49488,45686,allow,330,330,0,6,3609,6,0,1,"High deviation in pkts_sent, NAT Destination Port, Elapsed Time (sec)"
5234,28162,61929,28162,allow,449555,320,449235,719,50,6,713,1,"High deviation in pkts_sent, Bytes Received, Bytes"
49888,443,12324,443,allow,1072526,64733,1007793,1501,232,690,811,1,"High deviation in pkts_sent, Bytes Received, Bytes"
56816,80,41001,80,allow,420340,15216,405124,441,376,163,278,1,"High deviation in pkts_sent, Bytes Received, Bytes"
51767,59158,21535,59158,allow,70,70,0,2,8,2,0,1,"High deviation in pkts_sent, NAT Destination Port, Destination Port"
51008,80,51008,80,allow,114613,6365,108248,134,26,51,83,1,"High deviation in pkts_sent, Bytes Received, Bytes"
50880,80,50880,80,allow,163985,6578,157407,188,26,72,116,1,"High deviation in pkts_sent, Bytes Received, Bytes"
50916,80,44611,80,allow,11456216,116932,11339284,9298,139,1683,7615,1,"High deviation in pkts_sent, Bytes Received, Bytes"
50688,80,50688,80,allow,167293,8028,159265,186,26,68,118,1,"High deviation in pkts_sent, Bytes Received, Bytes"
48817,64245,48817,64245,allow,481,150,331,2,1200,1,1,1,"High deviation in NAT Destination Port, Destination Port, Elapsed Time (sec)"
65468,443,32669,443,allow,421329,12430,408899,433,16,152,281,1,"High deviation in pkts_sent, Bytes Received, Bytes"
55877,39578,13811,39578,allow,150,150,0,1,1200,1,0,1,"High deviation in NAT Destination Port, Destination Port, Elapsed Time (sec)"
49893,443,25504,443,allow,617481,41514,575967,856,221,381,475,1,"High deviation in pkts_sent, Bytes Received, Bytes"
59795,443,6313,443,allow,120014,7352,112662,155,37,64,91,1,"High deviation in pkts_sent, Bytes Received, Bytes"
51747,54301,33615,54301,allow,136,136,0,3,14,3,0,1,"High deviation in pkts_sent, NAT Destination Port, Destination Port"
51145,80,27456,80,allow,78198970,2041652,76157318,79332,368,28698,50634,1,"High deviation in pkts_sent, Bytes Received, Bytes"
54506,443,29033,443,allow,89702,83941,5761,91,181,66,25,1,"High deviation in pkts_sent, Bytes Sent, Bytes"
59788,443,40327,443,allow,134688,7027,127661,166,37,64,102,1,"High deviation in pkts_sent, Bytes Received, Bytes"
51135,443,21022,443,allow,640504,257235,383269,1476,797,643,833,1,"High deviation in pkts_sent, Bytes Sent, Bytes"
57949,5228,62651,5228,allow,2655,1540,1115,19,3601,9,10,1,"High deviation in pkts_sent, Elapsed Time (sec), NAT Destination Port"
51062,80,29351,80,allow,36568,23029,13539,94,194,47,47,1,"High deviation in pkts_sent, Bytes Sent, Bytes"
53551,60444,1391,60444,allow,492,306,186,8,15,5,3,1,"High deviation in pkts_sent, NAT Destination Port, Destination Port"
49230,443,49230,443,allow,123041,10988,112053,185,67,86,99,1,"High deviation in pkts_sent, Bytes Received, Bytes"
36258,443,41571,443,allow,1128432,47396,1081036,1242,142,458,784,1,"High deviation in pkts_sent, Bytes Received, Bytes"
65467,443,32500,443,allow,92244,4799,87445,107,15,43,64,1,"High deviation in pkts_sent, Bytes Received, Bytes"
35373,443,52870,443,allow,255313,6947,248366,253,123,74,179,1,"High deviation in pkts_sent, Bytes Received, Bytes"
51221,64509,12506,64509,allow,3564,3564,0,55,4073,55,0,1,"High deviation in pkts_sent, NAT Destination Port, Elapsed Time (sec)"
52652,443,42861,443,allow,283768,16167,267601,384,116,148,236,1,"High deviation in pkts_sent, Bytes Received, Bytes"
58541,28678,6280,28678,allow,1806,1806,0,22,224,22,0,1,"High deviation in pkts_sent, NAT Destination Port, Destination Port"
8168,80,8168,80,allow,282487,10736,271751,315,52,124,191,1,"High deviation in pkts_sent, Bytes Received, Bytes"
15503,56331,21797,56331,allow,481,150,331,2,1200,1,1,1,"High deviation in NAT Destination Port, Destination Port, Elapsed Time (sec)"
57470,52339,38751,52339,allow,594,594,0,10,1199,10,0,1,"High deviation in pkts_sent, NAT Destination Port, Destination Port"
57470,53377,9260,53377,allow,594,594,0,10,1199,10,0,1,"High deviation in pkts_sent, NAT Destination Port, Destination Port"
55231,443,25575,443,allow,10684454,328574,10355880,11599,77,3693,7906,1,"High deviation in pkts_sent, Bytes Received, Bytes"
28470,80,28470,80,allow,355544,12402,343142,378,26,134,244,1,"High deviation in pkts_sent, Bytes Received, Bytes"
50496,443,2792,443,allow,751676,8792,742884,617,16,123,494,1,"High deviation in pkts_sent, Bytes Received, Bytes"
28858,80,28858,80,allow,83253,4938,78315,99,26,39,60,1,"High deviation in pkts_sent, Bytes Received, Bytes"
53442,443,36564,443,allow,28728581,857403,27871178,29322,132,8944,20378,1,"High deviation in pkts_sent, Bytes Received, Bytes"
61475,443,7125,443,allow,198481,12339,186142,247,64,112,135,1,"High deviation in pkts_sent, Bytes Received, Bytes"
30960,45673,1133,45673,allow,462,462,0,8,3633,8,0,1,"High deviation in pkts_sent, NAT Destination Port, Elapsed Time (sec)"
28275,80,28275,80,allow,303421,10894,292527,324,26,116,208,1,"High deviation in pkts_sent, Bytes Received, Bytes"
50912,80,58684,80,allow,9578491,119422,9459069,8079,137,1689,6390,1,"High deviation in pkts_sent, Bytes Received, Bytes"
48568,443,2828,443,allow,56258,45661,10597,165,244,88,77,1,"High deviation in pkts_sent, Bytes Sent, Bytes"
49115,443,63602,443,allow,361013,18864,342149,392,296,110,282,1,"High deviation in pkts_sent, Bytes Received, Bytes"
49174,443,55183,443,allow,524887,14310,510577,546,18,201,345,1,"High deviation in pkts_sent, Bytes Received, Bytes"
28608,80,28608,80,allow,602483,18143,584340,627,27,219,408,1,"High deviation in pkts_sent, Bytes Received, Bytes"
49160,63307,39518,63307,allow,854,150,704,4,1200,2,2,1,"High deviation in pkts_sent, NAT Destination Port, Destination Port"
10151,55149,20876,55149,allow,481,150,331,2,1200,1,1,1,"High deviation in NAT Destination Port, Destination Port, Elapsed Time (sec)"
37616,443,9088,443,allow,702409,17257,685152,698,32,233,465,1,"High deviation in pkts_sent, Bytes Received, Bytes"
61476,443,42404,443,allow,230640,12863,217777,253,62,98,155,1,"High deviation in pkts_sent, Bytes Received, Bytes"
44277,443,64665,443,allow,36026,28458,7568,70,407,30,40,1,"High deviation in pkts_sent, Bytes Sent, Bytes"
8978,443,11135,443,allow,49938,20855,29083,165,216,81,84,1,"High deviation in pkts_sent, Bytes Sent, Bytes"
48889,443,65230,443,allow,87648,6895,80753,131,364,66,65,1,"High deviation in pkts_sent, Bytes Received, Bytes"
51650,80,36691,80,allow,141348,4210,137138,161,17,58,103,1,"High deviation in pkts_sent, Bytes Received, Bytes"
64112,443,40510,443,allow,4116645,96572,4020073,4029,58,1356,2673,1,"High deviation in pkts_sent, Bytes Received, Bytes"
50979,80,12190,80,allow,576971,8128,568843,497,38,114,383,1,"High deviation in pkts_sent, Bytes Received, Bytes"
36209,443,44738,443,allow,656609,25419,631190,752,62,322,430,1,"High deviation in pkts_sent, Bytes Received, Bytes"
51656,80,50242,80,allow,152651,4700,147951,174,17,65,109,1,"High deviation in pkts_sent, Bytes Received, Bytes"
63759,64509,33605,64509,allow,66,66,0,2,7,2,0,1,"High deviation in pkts_sent, NAT Destination Port, Destination Port"
42307,443,58231,443,allow,101673,5966,95707,121,178,47,74,1,"High deviation in pkts_sent, Bytes Received, Bytes"
53286,443,1896,443,allow,123194,68738,54456,402,287,167,235,1,"High deviation in pkts_sent, Bytes Sent, Bytes"
49214,443,4327,443,allow,17273,11238,6035,73,919,36,37,1,"High deviation in pkts_sent, Bytes Sent, Bytes"
59573,443,39847,443,allow,289380,13628,275752,335,70,142,193,1,"High deviation in pkts_sent, Bytes Received, Bytes"
51652,80,57447,80,allow,141220,4280,136940,159,17,59,100,1,"High deviation in pkts_sent, Bytes Received, Bytes"
58331,443,26953,443,allow,31515,26798,4717,91,82,49,42,1,"High deviation in pkts_sent, Bytes Sent, Bytes"
6881,39927,58260,39927,allow,228,118,110,2,1199,1,1,1,"High deviation in NAT Destination Port, Destination Port, Elapsed Time (sec)"
57470,33159,38691,33159,allow,594,594,0,10,1199,10,0,1,"High deviation in pkts_sent, NAT Destination Port, Destination Port"
46697,5228,40766,5228,allow,9263,549,8714,17,3638,5,12,1,"High deviation in pkts_sent, Elapsed Time (sec), Bytes Received"
50907,80,50964,80,allow,16037318,218904,15818414,13595,136,2976,10619,1,"High deviation in pkts_sent, Bytes Received, Bytes"
37174,443,43183,443,allow,752907,69016,683891,1372,231,537,835,1,"High deviation in pkts_sent, Bytes Received, Bytes"
53574,443,38690,443,allow,117116,5692,111424,153,18,56,97,1,"High deviation in pkts_sent, Bytes Received, Bytes"
53565,58695,57027,58695,allow,70,70,0,2,8,2,0,1,"High deviation in pkts_sent, NAT Destination Port, Destination Port"
30960,45684,7454,45684,allow,330,330,0,6,3609,6,0,1,"High deviation in pkts_sent, NAT Destination Port, Elapsed Time (sec)"
37965,22343,64266,22343,allow,1307,594,713,17,1657,10,7,1,"High deviation in pkts_sent, NAT Destination Port, Elapsed Time (sec)"
48252,443,35978,443,allow,283034,39462,243572,536,224,257,279,1,"High deviation in pkts_sent, Bytes Received, Bytes"
49224,443,16302,443,allow,93540,22718,70822,155,918,65,90,1,"High deviation in pkts_sent, Bytes Sent, Bytes"
7686,80,7686,80,allow,176670,11287,165383,216,46,96,120,1,"High deviation in pkts_sent, Bytes Received, Bytes"
49201,443,23062,443,allow,13738,6378,7360,70,981,33,37,1,"High deviation in pkts_sent, Bytes Sent, Bytes"
56739,42421,49450,42421,allow,2810,1382,1428,12,31,6,6,1,"High deviation in pkts_sent, NAT Destination Port, Destination Port"
63758,57825,49491,57825,allow,312,132,180,6,6,3,3,1,"High deviation in pkts_sent, NAT Destination Port, Destination Port"
51739,62163,32244,62163,allow,70,70,0,1,5,1,0,1,"High deviation in NAT Destination Port, Destination Port, NAT Source Port"
56843,443,16451,443,allow,54661,36820,17841,266,201,128,138,1,"High deviation in pkts_sent, Bytes Sent, Bytes"
44512,443,54023,443,allow,1101393,30310,1071083,1137,109,381,756,1,"High deviation in pkts_sent, Bytes Received, Bytes"
44516,443,18408,443,allow,156324,6993,149331,192,108,81,111,1,"High deviation in pkts_sent, Bytes Received, Bytes"
44514,443,59227,443,allow,448741,15805,432936,491,109,181,310,1,"High deviation in pkts_sent, Bytes Received, Bytes"
60384,64170,40565,64170,allow,504,318,186,8,16,5,3,1,"High deviation in pkts_sent, NAT Destination Port, Destination Port"
50540,443,25941,443,allow,134507,6585,127922,148,121,51,97,1,"High deviation in pkts_sent, Bytes Received, Bytes"
50265,13302,54682,13302,allow,2118,858,1260,28,1267,14,14,1,"High deviation in pkts_sent, NAT Destination Port, Elapsed Time (sec)"
53084,443,55326,443,allow,490914,83866,407048,1048,332,526,522,1,"High deviation in pkts_sent, Bytes Received, Bytes"
56841,443,47510,443,allow,156805,44621,112184,289,215,137,152,1,"High deviation in pkts_sent, Bytes Sent, Bytes"
6881,51413,35496,51413,allow,475,150,325,2,1200,1,1,1,"High deviation in NAT Destination Port, Destination Port, Elapsed Time (sec)"
50913,80,46319,80,allow,12767608,157856,12609752,11936,135,2227,9709,1,"High deviation in pkts_sent, Bytes Received, Bytes"
50906,80,26380,80,allow,13949172,164502,13784670,11537,135,2287,9250,1,"High deviation in pkts_sent, Bytes Received, Bytes"
50897,80,4903,80,allow,13981183,155668,13825515,11482,136,2194,9288,1,"High deviation in pkts_sent, Bytes Received, Bytes"
50910,80,20207,80,allow,14877069,179445,14697624,12450,135,2531,9919,1,"High deviation in pkts_sent, Bytes Received, Bytes"
50900,80,32944,80,allow,14423569,189925,14233644,12194,135,2586,9608,1,"High deviation in pkts_sent, Bytes Received, Bytes"
54688,443,54688,443,allow,149676,25300,124376,220,110,122,98,1,"High deviation in pkts_sent, Bytes Received, Bytes"
51265,63960,62847,63960,allow,70,70,0,1,5,1,0,1,"High deviation in NAT Destination Port, Destination Port, NAT Source Port"
7665,80,7665,80,allow,110567,7016,103551,135,46,60,75,1,"High deviation in pkts_sent, Bytes Received, Bytes"
50896,80,56677,80,allow,11459959,142694,11317265,9719,135,1994,7725,1,"High deviation in pkts_sent, Bytes Received, Bytes"
50917,80,57551,80,allow,11626518,135099,11491419,9627,134,1907,7720,1,"High deviation in pkts_sent, Bytes Received, Bytes"
50899,80,62536,80,allow,13974043,173337,13800706,11715,134,2429,9286,1,"High deviation in pkts_sent, Bytes Received, Bytes"
43483,443,14734,443,allow,144138,17538,126600,275,300,115,160,1,"High deviation in pkts_sent, Bytes Received, Bytes"
44847,46972,13667,46972,allow,150,150,0,1,1200,1,0,1,"High deviation in NAT Destination Port, Destination Port, Elapsed Time (sec)"
50901,80,6668,80,allow,14661588,141996,14519592,11768,134,2012,9756,1,"High deviation in pkts_sent, Bytes Received, Bytes"
50903,80,42549,80,allow,13644327,154437,13489890,11257,134,2201,9056,1,"High deviation in pkts_sent, Bytes Received, Bytes"
65466,443,13984,443,allow,478996,13760,465236,490,16,171,319,1,"High deviation in pkts_sent, Bytes Received, Bytes"
51667,25826,43364,25826,allow,9372,9372,0,11,30,11,0,1,"High deviation in pkts_sent, NAT Destination Port, Bytes Sent"
50825,443,30672,443,allow,252960,10277,242683,301,209,119,182,1,"High deviation in pkts_sent, Bytes Received, Bytes"
53541,59939,18832,59939,allow,70,70,0,1,5,1,0,1,"High deviation in NAT Destination Port, Destination Port, NAT Source Port"
65465,443,59471,443,allow,92040,4799,87241,107,16,43,64,1,"High deviation in pkts_sent, Bytes Received, Bytes"
61834,443,61834,443,allow,220115,6038,214077,231,76,78,153,1,"High deviation in pkts_sent, Bytes Received, Bytes"
50915,80,27954,80,allow,10548172,142265,10405907,9105,134,1982,7123,1,"High deviation in pkts_sent, Bytes Received, Bytes"
50911,80,6093,80,allow,13780884,170419,13610465,11542,134,2387,9155,1,"High deviation in pkts_sent, Bytes Received, Bytes"
51074,80,51074,80,allow,168467,7348,161119,184,8,67,117,1,"High deviation in pkts_sent, Bytes Received, Bytes"
63750,63343,38388,63343,allow,66,66,0,2,8,2,0,1,"High deviation in pkts_sent, NAT Destination Port, Destination Port"
50696,80,3909,80,allow,55872,28838,27034,234,175,117,117,1,"High deviation in pkts_sent, Bytes Sent, Bytes"
50692,80,35406,80,allow,57678,29714,27964,241,175,120,121,1,"High deviation in pkts_sent, Bytes Sent, Bytes"
50693,80,37544,80,allow,56849,29352,27497,239,175,120,119,1,"High deviation in pkts_sent, Bytes Sent, Bytes"
61836,443,61836,443,allow,132180,4407,127773,146,75,51,95,1,"High deviation in pkts_sent, Bytes Received, Bytes"
50695,80,60576,80,allow,58726,30286,28440,246,175,123,123,1,"High deviation in pkts_sent, Bytes Sent, Bytes"
57470,44224,31554,44224,allow,480,149,331,2,1200,1,1,1,"High deviation in NAT Destination Port, Destination Port, Elapsed Time (sec)"
52065,80,16889,80,allow,81670,2359,79311,89,621,30,59,1,"High deviation in pkts_sent, Bytes Received, Bytes"
50685,80,30111,80,allow,60374,30984,29390,250,175,123,127,1,"High deviation in pkts_sent, Bytes Sent, Bytes"
56772,61424,18304,61424,allow,70,70,0,2,8,2,0,1,"High deviation in pkts_sent, NAT Destination Port, Destination Port"
30960,45683,56128,45683,allow,330,330,0,6,3609,6,0,1,"High deviation in pkts_sent, NAT Destination Port, Elapsed Time (sec)"
30960,45670,41313,45670,allow,462,462,0,8,3632,8,0,1,"High deviation in pkts_sent, NAT Destination Port, Elapsed Time (sec)"
61030,443,16792,443,allow,109010,37307,71703,152,895,62,90,1,"High deviation in pkts_sent, Bytes Sent, Bytes"
50689,80,10754,80,allow,54757,28216,26541,229,175,114,115,1,"High deviation in pkts_sent, Bytes Sent, Bytes"
50697,80,44763,80,allow,54775,28230,26545,230,175,115,115,1,"High deviation in pkts_sent, Bytes Sent, Bytes"
43214,443,49896,443,allow,1563663,41030,1522633,1538,40,479,1059,1,"High deviation in pkts_sent, Bytes Received, Bytes"
56734,45086,42195,45086,allow,1640,460,1180,8,30,4,4,1,"High deviation in pkts_sent, NAT Destination Port, Destination Port"
50909,80,20271,80,allow,12826704,145724,12680980,10558,133,2024,8534,1,"High deviation in pkts_sent, Bytes Received, Bytes"
50902,80,26223,80,allow,12578792,132594,12446198,10198,133,1845,8353,1,"High deviation in pkts_sent, Bytes Received, Bytes"
60382,62582,16978,62582,allow,70,70,0,1,5,1,0,1,"High deviation in NAT Destination Port, Destination Port, Source Port"
60385,59696,6029,59696,allow,70,70,0,1,5,1,0,1,"High deviation in NAT Destination Port, Destination Port, Source Port"
43215,443,55751,443,allow,3245691,49693,3195998,2856,38,666,2190,1,"High deviation in pkts_sent, Bytes Received, Bytes"
55339,443,4853,443,allow,2552065,30474,2521591,2074,129,236,1838,1,"High deviation in pkts_sent, Bytes Received, Bytes"
51734,59825,48074,59825,allow,70,70,0,1,5,1,0,1,"High deviation in NAT Destination Port, Destination Port, NAT Source Port"
15503,42638,40530,42638,allow,1367,664,703,16,1200,9,7,1,"High deviation in pkts_sent, NAT Destination Port, Destination Port"
50908,80,37284,80,allow,14077960,171956,13906004,11755,133,2437,9318,1,"High deviation in pkts_sent, Bytes Received, Bytes"
50694,80,5032,80,allow,54760,27837,26923,229,175,114,115,1,"High deviation in pkts_sent, Bytes Sent, Bytes"
50824,443,63186,443,allow,337727,11283,326444,367,208,126,241,1,"High deviation in pkts_sent, Bytes Received, Bytes"
50602,443,33341,443,allow,572966,109738,463228,1277,624,639,638,1,"High deviation in pkts_sent, Bytes Received, Bytes"
52495,443,27354,443,allow,787462,10645,776817,653,131,87,566,1,"High deviation in pkts_sent, Bytes Received, Bytes"
37965,40840,26004,40840,allow,150,150,0,1,1199,1,0,1,"High deviation in NAT Destination Port, Destination Port, Elapsed Time (sec)"
54743,443,47896,443,allow,166136,7244,158892,202,149,76,126,1,"High deviation in pkts_sent, Bytes Received, Bytes"
63171,5228,60967,5228,allow,3535,1973,1562,36,3961,18,18,1,"High deviation in pkts_sent, Elapsed Time (sec), NAT Destination Port"
50691,80,17442,80,allow,55050,28089,26961,228,175,112,116,1,"High deviation in pkts_sent, Bytes Sent, Bytes"
50684,80,24128,80,allow,57576,29602,27974,239,175,118,121,1,"High deviation in pkts_sent, Bytes Sent, Bytes"
50703,80,3596,80,allow,54304,27807,26497,227,175,113,114,1,"High deviation in pkts_sent, Bytes Sent, Bytes"
30960,45679,3682,45679,allow,396,396,0,7,3615,7,0,1,"High deviation in pkts_sent, NAT Destination Port, Elapsed Time (sec)"
50700,80,20685,80,allow,55825,28792,27033,234,174,117,117,1,"High deviation in pkts_sent, Bytes Sent, Bytes"
50698,80,42687,80,allow,54871,28320,26551,231,174,116,115,1,"High deviation in pkts_sent, Bytes Sent, Bytes"
50690,80,44292,80,allow,56951,28706,28245,236,174,116,120,1,"High deviation in pkts_sent, Bytes Sent, Bytes"
50702,80,54989,80,allow,55224,28254,26970,230,174,114,116,1,"High deviation in pkts_sent, Bytes Sent, Bytes"
6881,19215,41309,19215,allow,509,150,359,2,1199,1,1,1,"High deviation in NAT Destination Port, Elapsed Time (sec), Destination Port"
50699,80,28391,80,allow,54318,27824,26494,227,174,113,114,1,"High deviation in pkts_sent, Bytes Sent, Bytes"
53559,58968,7595,58968,allow,70,70,0,2,7,2,0,1,"High deviation in pkts_sent, NAT Destination Port, Destination Port"
39532,443,10682,443,allow,345779,9537,336242,359,26,123,236,1,"High deviation in pkts_sent, Bytes Received, Bytes"
30188,59035,2297,59035,allow,1794,750,1044,12,4220,6,6,1,"High deviation in pkts_sent, NAT Destination Port, Elapsed Time (sec)"
52064,80,62647,80,allow,65658,3155,62503,76,621,26,50,1,"High deviation in pkts_sent, Bytes Received, Bytes"
53566,80,56289,80,allow,2270749,47314,2223435,2132,99,651,1481,1,"High deviation in pkts_sent, Bytes Received, Bytes"
55877,47528,12404,47528,allow,491,150,341,2,1200,1,1,1,"High deviation in NAT Destination Port, Destination Port, Elapsed Time (sec)"
49160,51413,10192,51413,allow,800,150,650,4,1200,2,2,1,"High deviation in pkts_sent, NAT Destination Port, Destination Port"
51221,65264,24402,65264,allow,870,330,540,12,1573,6,6,1,"High deviation in pkts_sent, NAT Destination Port, Destination Port"
57076,5222,34364,5222,allow,15600,7789,7811,155,169,82,73,1,"High deviation in pkts_sent, Bytes Sent, Packets"
53395,50321,40284,50321,allow,7546,4168,3378,37,53,24,13,1,"High deviation in pkts_sent, NAT Destination Port, Bytes Sent"
57470,31381,16195,31381,allow,792,792,0,13,1200,13,0,1,"High deviation in pkts_sent, NAT Destination Port, Elapsed Time (sec)"
45434,443,37816,443,allow,74123,16210,57913,106,57,52,54,1,"High deviation in pkts_sent, Bytes Received, Bytes"
30960,45682,63379,45682,allow,330,330,0,6,3609,6,0,1,"High deviation in pkts_sent, NAT Destination Port, Elapsed Time (sec)"
15503,27645,52952,27645,allow,480,149,331,2,1200,1,1,1,"High deviation in NAT Destination Port, Elapsed Time (sec), Destination Port"
57470,43155,32052,43155,allow,594,594,0,10,1199,10,0,1,"High deviation in pkts_sent, NAT Destination Port, Destination Port"
60377,65054,58961,65054,allow,624,318,306,10,15,5,5,1,"High deviation in pkts_sent, NAT Destination Port, Destination Port"
43206,443,34471,443,allow,4550611,95139,4455472,4046,217,935,3111,1,"High deviation in pkts_sent, Bytes Received, Bytes"
49501,80,23659,80,allow,183116,16652,166464,279,486,59,220,1,"High deviation in pkts_sent, Bytes Received, Bytes"
8430,53,21349,53,allow,80361,77433,2928,946,89,930,16,1,"High deviation in pkts_sent, Bytes Sent, Packets"
58853,443,38782,443,allow,59754,9493,50261,131,367,68,63,1,"High deviation in pkts_sent, Bytes Received, Bytes"
54954,443,24434,443,allow,469752,21060,448692,589,64,265,324,1,"High deviation in pkts_sent, Bytes Received, Bytes"
60376,58302,44068,58302,allow,624,318,306,10,15,5,5,1,"High deviation in pkts_sent, NAT Destination Port, Destination Port"
49268,443,60948,443,allow,77368,9874,67494,139,100,65,74,1,"High deviation in pkts_sent, Bytes Received, Bytes"
52711,443,64979,443,allow,107997,3957,104040,135,80,51,84,1,"High deviation in pkts_sent, Bytes Received, Bytes"
51729,63553,6792,63553,allow,70,70,0,1,5,1,0,1,"High deviation in NAT Destination Port, Destination Port, Bytes Received"
60874,443,2065,443,allow,777438,37182,740256,940,64,407,533,1,"High deviation in pkts_sent, Bytes Received, Bytes"
55367,443,46972,443,allow,101466,17775,83691,225,74,112,113,1,"High deviation in pkts_sent, Bytes Received, Bytes"
60390,56494,64175,56494,allow,70,70,0,2,8,2,0,1,"High deviation in pkts_sent, NAT Destination Port, Destination Port"
55588,49737,20798,49737,allow,504,318,186,8,15,5,3,1,"High deviation in pkts_sent, NAT Destination Port, Destination Port"
49503,80,52162,80,allow,121857,7431,114426,166,486,38,128,1,"High deviation in pkts_sent, Bytes Received, Bytes"
49500,80,17093,80,allow,309313,41646,267667,433,486,113,320,1,"High deviation in pkts_sent, Bytes Received, Bytes"
50265,55637,31401,55637,allow,528,528,0,9,1200,9,0,1,"High deviation in pkts_sent, NAT Destination Port, Destination Port"
49493,80,3964,80,allow,143422,12598,130824,226,487,52,174,1,"High deviation in pkts_sent, Bytes Received, Bytes"
35287,443,46797,443,allow,47587,20536,27051,345,581,173,172,1,"High deviation in pkts_sent, Bytes Sent, Bytes"
6881,6881,60771,6881,allow,150,150,0,1,1200,1,0,1,"High deviation in NAT Destination Port, Elapsed Time (sec), Destination Port"
57470,64919,63117,64919,allow,594,594,0,10,1199,10,0,1,"High deviation in pkts_sent, NAT Destination Port, Destination Port"
57470,56432,6012,56432,allow,132,132,0,3,1199,3,0,1,"High deviation in pkts_sent, NAT Destination Port, Destination Port"
63422,443,21466,443,allow,10617247,317598,10299649,11317,243,4141,7176,1,"High deviation in pkts_sent, Bytes Received, Bytes"
52277,80,52277,80,allow,259496,6676,252820,249,28,74,175,1,"High deviation in pkts_sent, Bytes Received, Bytes"
49708,443,54037,443,allow,456387,11878,444509,427,81,121,306,1,"High deviation in pkts_sent, Bytes Received, Bytes"
34885,443,20315,443,allow,80828,20592,60236,124,180,54,70,1,"High deviation in pkts_sent, Bytes Sent, Bytes"
52273,80,52273,80,allow,156876,7015,149861,158,28,49,109,1,"High deviation in pkts_sent, Bytes Received, Bytes"
60534,80,60534,80,allow,84558,3469,81089,94,16,34,60,1,"High deviation in pkts_sent, Bytes Received, Bytes"
52275,80,52275,80,allow,210890,8286,202604,208,28,64,144,1,"High deviation in pkts_sent, Bytes Received, Bytes"
52276,80,52276,80,allow,222010,7236,214774,216,28,66,150,1,"High deviation in pkts_sent, Bytes Received, Bytes"
52274,80,52274,80,allow,852970,14195,838775,769,28,207,562,1,"High deviation in pkts_sent, Bytes Received, Bytes"
60855,443,10736,443,allow,598135,40549,557586,873,251,326,547,1,"High deviation in pkts_sent, Bytes Received, Bytes"
15792,3478,30536,3478,allow,428935914,213443641,215492273,635946,2242,308738,327208,1,"High deviation in pkts_sent, Bytes Sent, Bytes"
49705,443,51038,443,allow,156357,6403,149954,155,81,44,111,1,"High deviation in pkts_sent, Bytes Received, Bytes"
8430,53,61822,53,allow,239209,233954,5255,2850,88,2822,28,1,"High deviation in pkts_sent, Bytes Sent, Packets"
52272,80,52272,80,allow,237488,7574,229914,231,27,71,160,1,"High deviation in pkts_sent, Bytes Received, Bytes"
42385,443,55838,443,allow,321621,14025,307596,408,41,185,223,1,"High deviation in pkts_sent, Bytes Received, Bytes"
49513,80,22592,80,allow,476333,9582,466751,453,225,135,318,1,"High deviation in pkts_sent, Bytes Received, Bytes"
54761,443,53919,443,allow,103367,3730,99637,117,170,42,75,1,"High deviation in pkts_sent, Bytes Received, Bytes"
57584,443,53316,443,allow,915797,52405,863392,1231,269,604,627,1,"High deviation in pkts_sent, Bytes Received, Bytes"
15503,11731,3627,11731,allow,1188,1188,0,19,2298,19,0,1,"High deviation in pkts_sent, NAT Destination Port, Elapsed Time (sec)"
36061,4500,28501,4500,allow,12526,5944,6582,24,3599,11,13,1,"High deviation in pkts_sent, Bytes Sent, Elapsed Time (sec)"
59669,80,64457,80,allow,2026957,42480,1984477,1975,80,655,1320,1,"High deviation in pkts_sent, Bytes Received, Bytes"
53526,45046,24762,45046,allow,552,306,246,9,15,5,4,1,"High deviation in pkts_sent, NAT Destination Port, Destination Port"
40252,443,46211,443,allow,543828,50144,493684,682,172,254,428,1,"High deviation in pkts_sent, Bytes Received, Bytes"
51221,57254,65381,57254,allow,491,150,341,2,1200,1,1,1,"High deviation in NAT Destination Port, Destination Port, Elapsed Time (sec)"
57347,443,57555,443,allow,1081375,19607,1061768,921,122,142,779,1,"High deviation in pkts_sent, Bytes Received, Bytes"
49555,443,34197,443,allow,740109,22948,717161,800,54,311,489,1,"High deviation in pkts_sent, Bytes Received, Bytes"
54649,443,1081,443,allow,355822,186974,168848,1039,1626,433,606,1,"High deviation in pkts_sent, Bytes Sent, Bytes"
49498,443,36900,443,allow,267319,11446,255873,336,192,117,219,1,"High deviation in pkts_sent, Bytes Received, Bytes"
52175,443,52175,443,allow,506908,20303,486605,548,25,204,344,1,"High deviation in pkts_sent, Bytes Received, Bytes"
41974,443,41974,443,allow,214163,29159,185004,242,20,108,134,1,"High deviation in pkts_sent, Bytes Received, Bytes"
6882,59689,61028,59689,allow,221,111,110,2,1200,1,1,1,"High deviation in NAT Destination Port, Destination Port, Elapsed Time (sec)"
50851,80,30396,80,allow,1123758,19319,1104439,1037,133,278,759,1,"High deviation in pkts_sent, Bytes Received, Bytes"
52095,443,20736,443,allow,325846,10609,315237,326,38,106,220,1,"High deviation in pkts_sent, Bytes Received, Bytes"
52100,443,47301,443,allow,298527,11814,286713,310,37,107,203,1,"High deviation in pkts_sent, Bytes Received, Bytes"
49846,443,59260,443,allow,278883,9002,269881,313,72,115,198,1,"High deviation in pkts_sent, Bytes Received, Bytes"
49850,443,7446,443,allow,147320,5771,141549,184,72,73,111,1,"High deviation in pkts_sent, Bytes Received, Bytes"
50265,61668,33376,61668,allow,132,132,0,3,1201,3,0,1,"High deviation in pkts_sent, NAT Destination Port, Destination Port"
54753,443,7702,443,allow,84945,5052,79893,120,360,61,59,1,"High deviation in pkts_sent, Bytes Received, Bytes"
49862,443,63314,443,allow,819841,23462,796379,897,56,298,599,1,"High deviation in pkts_sent, Bytes Received, Bytes"
65464,443,36070,443,allow,395647,11870,383777,409,16,144,265,1,"High deviation in pkts_sent, Bytes Received, Bytes"
51739,62163,31026,62163,allow,70,70,0,2,8,2,0,1,"High deviation in pkts_sent, NAT Destination Port, Destination Port"
51768,80,6690,80,allow,211684,9903,201781,247,27,109,138,1,"High deviation in pkts_sent, Bytes Received, Bytes"
51770,80,6696,80,allow,135293,6214,129079,161,24,71,90,1,"High deviation in pkts_sent, Bytes Received, Bytes"
50970,80,27517,80,allow,1123476,15099,1108377,963,39,223,740,1,"High deviation in pkts_sent, Bytes Received, Bytes"
49959,443,21643,443,allow,102240,4349,97891,128,136,46,82,1,"High deviation in pkts_sent, Bytes Received, Bytes"
19473,44929,9531,44929,allow,481,150,331,2,1200,1,1,1,"High deviation in NAT Destination Port, Destination Port, Elapsed Time (sec)"
37450,443,11367,443,allow,617919,23432,594487,706,39,297,409,1,"High deviation in pkts_sent, Bytes Received, Bytes"
51772,80,5918,80,allow,93693,4469,89224,115,24,53,62,1,"High deviation in pkts_sent, Bytes Received, Bytes"
60873,443,47153,443,allow,60954,33730,27224,101,63,50,51,1,"High deviation in pkts_sent, Bytes Sent, Bytes"
57294,443,32624,443,allow,122959,4611,118348,142,150,51,91,1,"High deviation in pkts_sent, Bytes Received, Bytes"
39569,443,64666,443,allow,125906,21096,104810,172,130,68,104,1,"High deviation in pkts_sent, Bytes Received, Bytes"
57470,20014,49843,20014,allow,528,528,0,9,1200,9,0,1,"High deviation in pkts_sent, NAT Destination Port, Elapsed Time (sec)"
48344,443,10226,443,allow,68467,4750,63717,100,276,48,52,1,"High deviation in pkts_sent, Bytes Received, Bytes"
49858,443,16431,443,allow,2027955,75406,1952549,2104,60,564,1540,1,"High deviation in pkts_sent, Bytes Received, Bytes"
49889,443,5001,443,allow,214782,13389,201393,277,50,98,179,1,"High deviation in pkts_sent, Bytes Received, Bytes"
47534,443,60052,443,allow,291717,11752,279965,319,137,123,196,1,"High deviation in pkts_sent, Bytes Received, Bytes"
51221,53239,19108,53239,allow,1487,594,893,19,1571,10,9,1,"High deviation in pkts_sent, NAT Destination Port, Destination Port"
56341,443,32673,443,allow,49417,5511,43906,108,439,54,54,1,"High deviation in pkts_sent, Bytes Received, Bytes"
49511,80,32515,80,allow,1693924,34466,1659458,1627,230,522,1105,1,"High deviation in pkts_sent, Bytes Received, Bytes"
50265,64304,32485,64304,allow,970,598,372,14,1201,8,6,1,"High deviation in pkts_sent, NAT Destination Port, Destination Port"
56430,443,5643,443,allow,2274816,85295,2189521,2305,127,825,1480,1,"High deviation in pkts_sent, Bytes Received, Bytes"
55049,5228,10544,5228,allow,9193,2770,6423,51,5193,28,23,1,"High deviation in pkts_sent, Elapsed Time (sec), Bytes Sent"
52921,443,44773,443,allow,36892,20283,16609,191,116,77,114,1,"High deviation in pkts_sent, Bytes Sent, Bytes"
52879,443,43280,443,allow,286404,12478,273926,379,118,130,249,1,"High deviation in pkts_sent, Bytes Received, Bytes"
52918,443,11338,443,allow,326078,45627,280451,737,116,252,485,1,"High deviation in pkts_sent, Bytes Received, Bytes"
53127,443,49935,443,allow,68982,15774,53208,113,45,42,71,1,"High deviation in pkts_sent, Bytes, Bytes Received"
52880,443,45002,443,allow,1695880,25777,1670103,1423,118,264,1159,1,"High deviation in pkts_sent, Bytes Received, Bytes"
51265,63960,52529,63960,allow,70,70,0,2,8,2,0,1,"High deviation in pkts_sent, NAT Destination Port, Destination Port"
50848,80,48215,80,allow,1213557,27203,1186354,1120,133,327,793,1,"High deviation in pkts_sent, Bytes Received, Bytes"
52903,443,57569,443,allow,253281,6271,247010,276,117,66,210,1,"High deviation in pkts_sent, Bytes Received, Bytes"
52876,443,35265,443,allow,501046,7967,493079,419,118,69,350,1,"High deviation in pkts_sent, Bytes Received, Bytes"
64915,443,15491,443,allow,4659604,120303,4539301,4651,74,1586,3065,1,"High deviation in pkts_sent, Bytes Received, Bytes"
52865,443,62658,443,allow,120290,2988,117302,123,132,32,91,1,"High deviation in pkts_sent, Bytes Received, Bytes"
54952,5228,14099,5228,allow,12140,3028,9112,54,4653,28,26,1,"High deviation in pkts_sent, Elapsed Time (sec), Bytes Sent"
64914,443,15488,443,allow,6120028,157580,5962448,6108,75,2083,4025,1,"High deviation in pkts_sent, Bytes Received, Bytes"
57470,46772,63151,46772,allow,528,528,0,9,1201,9,0,1,"High deviation in pkts_sent, NAT Destination Port, Destination Port"
55478,443,16411,443,allow,23029908,732047,22297861,24550,183,8143,16407,1,"High deviation in pkts_sent, Bytes Received, Bytes"
49882,443,51154,443,allow,79524,18512,61012,205,50,101,104,1,"High deviation in pkts_sent, Bytes, Bytes Received"
50265,33734,14802,33734,allow,132,132,0,3,1200,3,0,1,"High deviation in pkts_sent, NAT Destination Port, Destination Port"
52975,443,20822,443,allow,291803,6522,285281,284,113,58,226,1,"High deviation in pkts_sent, Bytes Received, Bytes"
50852,80,1179,80,allow,1118864,18787,1100077,1036,132,280,756,1,"High deviation in pkts_sent, Bytes Received, Bytes"
50849,80,37869,80,allow,1218354,26709,1191645,1128,133,332,796,1,"High deviation in pkts_sent, Bytes Received, Bytes"
49897,443,23230,443,allow,33013,21249,11764,151,492,79,72,1,"High deviation in pkts_sent, Bytes Sent, Bytes"
50972,80,5146,80,allow,1095399,7129,1088270,832,37,106,726,1,"High deviation in pkts_sent, Bytes Received, Bytes"
60871,443,15673,443,allow,95311,21869,73442,140,62,61,79,1,"High deviation in pkts_sent, Bytes, Bytes Received"
52951,443,13326,443,allow,628801,19603,609198,708,114,227,481,1,"High deviation in pkts_sent, Bytes Received, Bytes"
49499,443,13640,443,allow,87970,5355,82615,141,483,55,86,1,"High deviation in pkts_sent, Bytes Received, Bytes"
41059,443,46382,443,allow,1248874,30382,1218492,1261,111,425,836,1,"High deviation in pkts_sent, Bytes Received, Bytes"
58677,28678,3047,28678,allow,1806,1806,0,22,225,22,0,1,"High deviation in pkts_sent, NAT Destination Port, Destination Port"
52944,443,11890,443,allow,58499,47163,11336,106,115,59,47,1,"High deviation in pkts_sent, Bytes Sent, Bytes"
50244,80,52530,80,allow,136475,59298,77177,166,53,78,88,1,"High deviation in pkts_sent, Bytes Sent, Bytes"
51666,45702,58433,45702,allow,1201,577,624,8,30,4,4,1,"High deviation in pkts_sent, NAT Destination Port, Destination Port"
41657,443,13161,443,allow,122547,6414,116133,160,81,61,99,1,"High deviation in pkts_sent, Bytes Received, Bytes"
36262,443,11222,443,allow,678861,22499,656362,749,19,290,459,1,"High deviation in pkts_sent, Bytes Received, Bytes"
49877,443,32997,443,allow,37364,16799,20565,189,53,87,102,1,"High deviation in pkts_sent, Bytes Sent, Bytes"
63127,55860,37307,55860,allow,316,190,126,5,15,3,2,1,"High deviation in pkts_sent, NAT Destination Port, Destination Port"
35106,443,63708,443,allow,309321,13076,296245,368,189,150,218,1,"High deviation in pkts_sent, Bytes Received, Bytes"
60878,443,38028,443,allow,764899,31427,733472,883,60,368,515,1,"High deviation in pkts_sent, Bytes Received, Bytes"
60840,443,45920,443,allow,54975,32043,22932,71,319,40,31,1,"High deviation in pkts_sent, Bytes Sent, Bytes"
50878,80,60118,80,allow,325925,18062,307863,377,146,161,216,1,"High deviation in pkts_sent, Bytes Received, Bytes"
62705,443,21442,443,allow,357841,77119,280722,646,142,316,330,1,"High deviation in pkts_sent, Bytes Received, Bytes"
36261,443,56856,443,allow,1269784,41489,1228295,1339,37,478,861,1,"High deviation in pkts_sent, Bytes Received, Bytes"
65463,443,25060,443,allow,92752,4519,88233,105,15,39,66,1,"High deviation in pkts_sent, Bytes Received, Bytes"
40521,28678,47764,28678,allow,1806,1806,0,22,225,22,0,1,"High deviation in pkts_sent, NAT Destination Port, Destination Port"
36256,443,38729,443,allow,3936219,107920,3828299,3880,132,1208,2672,1,"High deviation in pkts_sent, Bytes Received, Bytes"
52891,443,27899,443,allow,320255,9207,311048,343,117,107,236,1,"High deviation in pkts_sent, Bytes Received, Bytes"
52961,443,6824,443,allow,925322,25097,900225,971,113,287,684,1,"High deviation in pkts_sent, Bytes Received, Bytes"
50968,443,54503,443,allow,13683,6075,7608,58,5113,23,35,1,"High deviation in pkts_sent, Elapsed Time (sec), Bytes Sent"
50974,80,21113,80,allow,1095989,7833,1088156,841,37,117,724,1,"High deviation in pkts_sent, Bytes Received, Bytes"
49880,443,51797,443,allow,1087632,32231,1055401,1112,53,334,778,1,"High deviation in pkts_sent, Bytes Received, Bytes"
49871,443,47130,443,allow,615040,25597,589443,704,54,245,459,1,"High deviation in pkts_sent, Bytes Received, Bytes"
21133,59392,22505,59392,allow,481,150,331,2,1199,1,1,1,"High deviation in NAT Destination Port, Destination Port, Elapsed Time (sec)"
50977,80,25806,80,allow,1111949,11633,1100316,906,37,173,733,1,"High deviation in pkts_sent, Bytes Received, Bytes"
48252,443,55839,443,allow,60300,47341,12959,192,39,108,84,1,"High deviation in pkts_sent, Bytes Sent, Bytes"
53080,443,53725,443,allow,108155,4527,103628,115,83,30,85,1,"High deviation in pkts_sent, Bytes Received, Bytes"
52861,443,16498,443,allow,3633587,34615,3598972,2964,137,514,2450,1,"High deviation in pkts_sent, Bytes Received, Bytes"
52874,443,59388,443,allow,392514,41757,350757,626,118,209,417,1,"High deviation in pkts_sent, Bytes Received, Bytes"
52872,443,5601,443,allow,110507,3940,106567,129,118,37,92,1,"High deviation in pkts_sent, Bytes Received, Bytes"
49840,443,9507,443,allow,58656,12994,45662,148,71,64,84,1,"High deviation in pkts_sent, Bytes Received, Bytes"
52870,443,27625,443,allow,113894,15573,98321,182,119,67,115,1,"High deviation in pkts_sent, Bytes Received, Bytes"
52989,443,57788,443,allow,182945,23135,159810,191,111,63,128,1,"High deviation in pkts_sent, Bytes Received, Bytes"
57470,25089,59334,25089,allow,132,132,0,3,1199,3,0,1,"High deviation in pkts_sent, NAT Destination Port, Elapsed Time (sec)"
52910,443,4102,443,allow,179433,12614,166819,217,116,78,139,1,"High deviation in pkts_sent, Bytes Received, Bytes"
41095,443,28178,443,allow,108842,88940,19902,313,255,159,154,1,"High deviation in pkts_sent, Bytes Sent, Bytes"
47274,5223,2647,5223,allow,4269,1451,2818,22,3002,13,9,1,"High deviation in pkts_sent, Elapsed Time (sec), NAT Destination Port"
60303,443,45517,443,allow,7914400,166459,7747941,6839,775,1138,5701,1,"High deviation in pkts_sent, Bytes Received, Bytes"
57470,51413,17602,51413,allow,330,330,0,6,1199,6,0,1,"High deviation in pkts_sent, NAT Destination Port, Destination Port"
57470,46501,13184,46501,allow,132,132,0,3,1199,3,0,1,"High deviation in pkts_sent, NAT Destination Port, Destination Port"
50265,42698,16471,42698,allow,726,726,0,12,1200,12,0,1,"High deviation in pkts_sent, NAT Destination Port, Destination Port"
52933,80,52933,80,allow,98765,5293,93472,131,199,48,83,1,"High deviation in pkts_sent, Bytes Received, Bytes"
63720,55027,38364,55027,allow,1233,902,331,12,17,8,4,1,"High deviation in pkts_sent, NAT Destination Port, Destination Port"
38807,443,45968,443,allow,99092,3694,95398,115,170,43,72,1,"High deviation in pkts_sent, Bytes Received, Bytes"
50537,5223,31982,5223,allow,12710,4688,8022,44,2961,19,25,1,"High deviation in pkts_sent, Elapsed Time (sec), Bytes Sent"
51717,63436,58721,63436,allow,66,66,0,1,5,1,0,1,"High deviation in NAT Destination Port, Destination Port, NAT Source Port"
50870,5228,4125,5228,allow,7069,1804,5265,20,3602,11,9,1,"High deviation in pkts_sent, Elapsed Time (sec), NAT Destination Port"
49160,28890,3522,28890,allow,830,150,680,4,1200,2,2,1,"High deviation in pkts_sent, NAT Destination Port, Elapsed Time (sec)"
51734,59825,40402,59825,allow,70,70,0,2,8,2,0,1,"High deviation in pkts_sent, NAT Destination Port, Destination Port"
60385,59696,28455,59696,allow,70,70,0,2,8,2,0,1,"High deviation in pkts_sent, NAT Destination Port, Destination Port"
60382,62582,18649,62582,allow,70,70,0,2,8,2,0,1,"High deviation in pkts_sent, NAT Destination Port, Destination Port"
35666,443,50206,443,allow,3389452,85022,3304430,3290,159,997,2293,1,"High deviation in pkts_sent, Bytes Received, Bytes"
50969,80,54293,80,allow,921711,12229,909482,780,37,172,608,1,"High deviation in pkts_sent, Bytes Received, Bytes"
50973,80,49428,80,allow,1095221,7065,1088156,829,36,105,724,1,"High deviation in pkts_sent, Bytes Received, Bytes"
53156,51689,64576,51689,allow,546,306,240,9,142,5,4,1,"High deviation in pkts_sent, NAT Destination Port, Destination Port"
53541,59939,24806,59939,allow,70,70,0,2,7,2,0,1,"High deviation in pkts_sent, NAT Destination Port, Destination Port"
60047,443,20320,443,allow,229060,38515,190545,283,135,113,170,1,"High deviation in pkts_sent, Bytes Received, Bytes"
33048,443,57285,443,allow,90054,6681,83373,104,133,33,71,1,"High deviation in pkts_sent, Bytes Received, Bytes"
49168,443,13690,443,allow,519325,13798,505527,535,18,193,342,1,"High deviation in pkts_sent, Bytes Received, Bytes"
17750,30022,45838,30022,allow,481,150,331,2,1200,1,1,1,"High deviation in NAT Destination Port, Elapsed Time (sec), Destination Port"
64586,80,64586,80,allow,123115,6863,116252,160,29,76,84,1,"High deviation in pkts_sent, Bytes Received, Bytes"
58082,443,14473,443,allow,45314943,1391230,43923713,47149,303,15196,31953,1,"High deviation in pkts_sent, Bytes Received, Bytes"
48408,443,3268,443,allow,115036,11567,103469,189,103,92,97,1,"High deviation in pkts_sent, Bytes Received, Bytes"
50971,80,41640,80,allow,1094437,6233,1088204,817,36,92,725,1,"High deviation in pkts_sent, Bytes Received, Bytes"
54165,443,54165,443,allow,147750,13521,134229,182,92,84,98,1,"High deviation in pkts_sent, Bytes Received, Bytes"
52173,443,52173,443,allow,201007,10015,190992,239,22,100,139,1,"High deviation in pkts_sent, Bytes Received, Bytes"
64600,80,64600,80,allow,98859,6426,92433,136,27,68,68,1,"High deviation in pkts_sent, Bytes Received, Bytes"
49430,443,47050,443,allow,18859,5795,13064,62,3666,28,34,1,"High deviation in pkts_sent, Elapsed Time (sec), Bytes Sent"
30960,45676,24387,45676,allow,396,396,0,7,3616,7,0,1,"High deviation in pkts_sent, NAT Destination Port, Elapsed Time (sec)"
54387,5228,7370,5228,allow,7019,1592,5427,25,3600,14,11,1,"High deviation in pkts_sent, Elapsed Time (sec), NAT Destination Port"
38603,5228,52662,5228,allow,3534,1679,1855,30,3640,11,19,1,"High deviation in pkts_sent, Elapsed Time (sec), NAT Destination Port"
52171,443,52171,443,allow,154883,8710,146173,182,23,69,113,1,"High deviation in pkts_sent, Bytes Received, Bytes"
53106,59478,22060,59478,allow,70,70,0,1,5,1,0,1,"High deviation in NAT Destination Port, Destination Port, NAT Source Port"
52176,443,52176,443,allow,126525,6370,120155,147,22,56,91,1,"High deviation in pkts_sent, Bytes Received, Bytes"
49542,443,62121,443,allow,40423,35897,4526,52,16,33,19,1,"High deviation in pkts_sent, Bytes Sent, Bytes"
53542,50321,25266,50321,allow,320,140,180,6,6,3,3,1,"High deviation in pkts_sent, NAT Destination Port, Destination Port"
57470,34617,39417,34617,allow,481,150,331,2,1199,1,1,1,"High deviation in NAT Destination Port, Destination Port, Elapsed Time (sec)"
50975,80,56708,80,allow,1095845,7641,1088204,839,35,114,725,1,"High deviation in pkts_sent, Bytes Received, Bytes"
50976,80,46012,80,allow,1094127,5977,1088150,812,35,88,724,1,"High deviation in pkts_sent, Bytes Received, Bytes"
58984,443,13660,443,allow,4874459,114404,4760055,4469,188,1112,3357,1,"High deviation in pkts_sent, Bytes Received, Bytes"
50584,51748,57588,51748,allow,1356,300,1056,6,1200,3,3,1,"High deviation in pkts_sent, NAT Destination Port, Destination Port"
49573,80,24541,80,allow,180917,5183,175734,175,65,49,126,1,"High deviation in pkts_sent, Bytes Received, Bytes"
49579,80,10648,80,allow,277736,7810,269926,277,65,91,186,1,"High deviation in pkts_sent, Bytes Received, Bytes"
49577,80,46203,80,allow,147113,4021,143092,144,65,41,103,1,"High deviation in pkts_sent, Bytes Received, Bytes"
57256,443,52300,443,allow,47762,39522,8240,77,332,43,34,1,"High deviation in pkts_sent, Bytes Sent, Bytes"
50121,443,24047,443,allow,307104860,2750998,304353862,234597,6122,15017,219580,1,"High deviation in pkts_sent, Bytes Received, Bytes"
49576,80,6202,80,allow,174140,4942,169198,166,65,47,119,1,"High deviation in pkts_sent, Bytes Received, Bytes"
30960,45656,54549,45656,allow,66,66,0,1,3600,1,0,1,"High deviation in NAT Destination Port, Elapsed Time (sec), Destination Port"
50584,62833,22282,62833,allow,1275,300,975,6,1200,3,3,1,"High deviation in pkts_sent, NAT Destination Port, Destination Port"
50584,54321,2526,54321,allow,1275,300,975,6,1200,3,3,1,"High deviation in pkts_sent, NAT Destination Port, Destination Port"
50584,30773,22058,30773,allow,1356,300,1056,6,1200,3,3,1,"High deviation in pkts_sent, NAT Destination Port, Elapsed Time (sec)"
50584,45270,4666,45270,allow,1377,300,1077,6,1200,3,3,1,"High deviation in pkts_sent, NAT Destination Port, Destination Port"
30960,45665,23931,45665,allow,462,462,0,8,3632,8,0,1,"High deviation in pkts_sent, NAT Destination Port, Elapsed Time (sec)"
50584,28020,62483,28020,allow,1302,300,1002,6,1200,3,3,1,"High deviation in pkts_sent, NAT Destination Port, Elapsed Time (sec)"
50584,54993,58004,54993,allow,652,300,352,4,1200,3,1,1,"High deviation in pkts_sent, NAT Destination Port, Destination Port"
50880,80,36202,80,allow,395978,13168,382810,411,143,151,260,1,"High deviation in pkts_sent, Bytes Received, Bytes"
57594,443,55656,443,allow,614577,24675,589902,673,149,228,445,1,"High deviation in pkts_sent, Bytes Received, Bytes"
51737,54691,48488,54691,allow,316,136,180,6,5,3,3,1,"High deviation in pkts_sent, NAT Destination Port, Destination Port"
50584,51413,45972,51413,allow,1275,300,975,6,1200,3,3,1,"High deviation in pkts_sent, NAT Destination Port, Destination Port"
49885,443,30250,443,allow,4626083,113708,4512375,4382,213,1198,3184,1,"High deviation in pkts_sent, Bytes Received, Bytes"
43210,443,51289,443,allow,5960402,99613,5860789,5017,133,952,4065,1,"High deviation in pkts_sent, Bytes Received, Bytes"
49608,80,59432,80,allow,145752,3240,142512,128,61,23,105,1,"High deviation in pkts_sent, Bytes Received, Bytes"
62237,443,62237,443,allow,169315,5255,164060,190,77,66,124,1,"High deviation in pkts_sent, Bytes Received, Bytes"
51729,63553,13105,63553,allow,70,70,0,2,8,2,0,1,"High deviation in pkts_sent, NAT Destination Port, Destination Port"
60961,443,5669,443,allow,75122,4244,70878,101,45,48,53,1,"High deviation in pkts_sent, Bytes Received, Bytes"
50584,54741,14563,54741,allow,868,150,718,4,1200,2,2,1,"High deviation in pkts_sent, NAT Destination Port, Destination Port"
55581,64301,29198,64301,allow,316,190,126,5,15,3,2,1,"High deviation in pkts_sent, NAT Destination Port, Destination Port"
50584,25935,2865,25935,allow,1377,300,1077,6,1200,3,3,1,"High deviation in pkts_sent, NAT Destination Port, Elapsed Time (sec)"
50584,55624,58737,55624,allow,1326,300,1026,6,1200,3,3,1,"High deviation in pkts_sent, NAT Destination Port, Destination Port"
50584,51413,47261,51413,allow,1275,300,975,6,1200,3,3,1,"High deviation in pkts_sent, NAT Destination Port, Destination Port"
44586,443,61467,443,allow,122708,5797,116911,169,132,75,94,1,"High deviation in pkts_sent, Bytes Received, Bytes"
50929,80,17624,80,allow,9630744,98097,9532647,7804,123,1387,6417,1,"High deviation in pkts_sent, Bytes Received, Bytes"
64584,80,64584,80,allow,142674,8057,134617,192,27,94,98,1,"High deviation in pkts_sent, Bytes Received, Bytes"
49698,80,3522,80,allow,140258,1720,138538,117,52,18,99,1,"High deviation in pkts_sent, Bytes Received, Bytes"
50584,56112,8598,56112,allow,1377,300,1077,6,1200,3,3,1,"High deviation in pkts_sent, NAT Destination Port, Destination Port"
50584,61467,32483,61467,allow,1377,300,1077,6,1200,3,3,1,"High deviation in pkts_sent, NAT Destination Port, Destination Port"
50584,40420,46560,40420,allow,868,150,718,4,1200,2,2,1,"High deviation in pkts_sent, NAT Destination Port, Destination Port"
50584,49376,27285,49376,allow,1320,300,1020,6,1200,3,3,1,"High deviation in pkts_sent, NAT Destination Port, Destination Port"
50584,54157,4800,54157,allow,1377,300,1077,6,1200,3,3,1,"High deviation in pkts_sent, NAT Destination Port, Destination Port"
50584,21094,39450,21094,allow,1356,300,1056,6,1200,3,3,1,"High deviation in pkts_sent, NAT Destination Port, Elapsed Time (sec)"
54525,80,24122,80,allow,50436663,1205750,49230913,49415,198,16827,32588,1,"High deviation in pkts_sent, Bytes Received, Bytes"
50584,38578,41911,38578,allow,1377,300,1077,6,1200,3,3,1,"High deviation in pkts_sent, NAT Destination Port, Destination Port"
50584,51413,31560,51413,allow,800,150,650,4,1200,2,2,1,"High deviation in pkts_sent, NAT Destination Port, Destination Port"
50584,49001,36650,49001,allow,1290,300,990,6,1200,3,3,1,"High deviation in pkts_sent, NAT Destination Port, Destination Port"
50584,47174,17468,47174,allow,300,300,0,3,1200,3,0,1,"High deviation in pkts_sent, NAT Destination Port, Destination Port"
55877,62071,53667,62071,allow,481,150,331,2,1200,1,1,1,"High deviation in NAT Destination Port, Destination Port, Elapsed Time (sec)"
38770,5228,21583,5228,allow,6033,1874,4159,33,4073,11,22,1,"High deviation in pkts_sent, Elapsed Time (sec), NAT Destination Port"
46999,993,56009,993,allow,45153,20621,24532,323,43,165,158,1,"High deviation in pkts_sent, Bytes Sent, Bytes"
50933,80,44380,80,allow,9932735,85391,9847344,7875,123,1237,6638,1,"High deviation in pkts_sent, Bytes Received, Bytes"
46488,443,7780,443,allow,87129,6924,80205,126,258,49,77,1,"High deviation in pkts_sent, Bytes Received, Bytes"
23293,443,23293,443,allow,50236,37417,12819,67,19,41,26,1,"High deviation in pkts_sent, Bytes Sent, Bytes"
59808,443,49702,443,allow,147637,6160,141477,164,121,56,108,1,"High deviation in pkts_sent, Bytes Received, Bytes"
64601,80,64601,80,allow,56887,6820,50067,90,25,49,41,1,"High deviation in pkts_sent, Bytes Received, Bytes"
35105,443,59131,443,allow,639937,14873,625064,627,230,188,439,1,"High deviation in pkts_sent, Bytes Received, Bytes"
64585,80,64585,80,allow,405673,21057,384616,519,26,252,267,1,"High deviation in pkts_sent, Bytes Received, Bytes"
55579,58420,44629,58420,allow,70,70,0,1,5,1,0,1,"High deviation in NAT Destination Port, Destination Port, NAT Source Port"
65461,443,11386,443,allow,396698,11870,384828,409,16,144,265,1,"High deviation in pkts_sent, Bytes Received, Bytes"
53663,80,16666,80,allow,149148,7515,141633,197,20,95,102,1,"High deviation in pkts_sent, Bytes Received, Bytes"
37965,51719,40903,51719,allow,481,150,331,2,1199,1,1,1,"High deviation in NAT Destination Port, Destination Port, Elapsed Time (sec)"
35101,443,31000,443,allow,4988930,161289,4827641,5384,290,1964,3420,1,"High deviation in pkts_sent, Bytes Received, Bytes"
56429,443,9683,443,allow,355939,9284,346655,365,121,125,240,1,"High deviation in pkts_sent, Bytes Received, Bytes"
15503,21394,46725,21394,allow,479,150,329,2,1200,1,1,1,"High deviation in NAT Destination Port, Elapsed Time (sec), Destination Port"
6882,24271,34047,24271,allow,228,118,110,2,1200,1,1,1,"High deviation in NAT Destination Port, Elapsed Time (sec), Destination Port"
50961,80,36404,80,allow,5730066,61301,5668765,4686,81,891,3795,1,"High deviation in pkts_sent, Bytes Received, Bytes"
42298,51408,45869,51408,allow,725,325,400,12,31,6,6,1,"High deviation in pkts_sent, NAT Destination Port, Destination Port"
43314,443,11137,443,allow,27958,21973,5985,77,403,43,34,1,"High deviation in pkts_sent, Bytes Sent, Bytes"
37780,443,20085,443,allow,1403708,31893,1371815,1301,162,292,1009,1,"High deviation in pkts_sent, Bytes Received, Bytes"
51728,55504,11641,55504,allow,316,136,180,6,6,3,3,1,"High deviation in pkts_sent, NAT Destination Port, Destination Port"
51698,63846,26436,63846,allow,66,66,0,1,5,1,0,1,"High deviation in NAT Destination Port, Destination Port, NAT Source Port"
54521,443,4685,443,allow,1574197,46737,1527460,1590,34,557,1033,1,"High deviation in pkts_sent, Bytes Received, Bytes"
33624,443,6639,443,allow,247438,52606,194832,305,237,124,181,1,"High deviation in pkts_sent, Bytes Received, Bytes"
50877,80,27709,80,allow,186520,11545,174975,222,141,96,126,1,"High deviation in pkts_sent, Bytes Received, Bytes"
46417,443,30278,443,allow,359878,6703,353175,325,36,88,237,1,"High deviation in pkts_sent, Bytes Received, Bytes"
50935,80,3414,80,allow,8167195,108448,8058747,7107,121,1531,5576,1,"High deviation in pkts_sent, Bytes Received, Bytes"
34765,5222,48630,5222,allow,10109,3480,6629,72,615,38,34,1,"High deviation in pkts_sent, Bytes Sent, NAT Destination Port"
50890,80,12548,80,allow,290951,15209,275742,327,141,132,195,1,"High deviation in pkts_sent, Bytes Received, Bytes"
50876,80,52453,80,allow,121344,7345,113999,144,141,61,83,1,"High deviation in pkts_sent, Bytes Received, Bytes"
50892,80,51133,80,allow,256436,14131,242305,283,141,111,172,1,"High deviation in pkts_sent, Bytes Received, Bytes"
50886,80,22505,80,allow,312952,13869,299083,347,141,138,209,1,"High deviation in pkts_sent, Bytes Received, Bytes"
62768,443,53717,443,allow,30902,6307,24595,86,269,36,50,1,"High deviation in pkts_sent, Bytes Received, Bytes"
50883,80,64742,80,allow,204646,11741,192905,240,141,104,136,1,"High deviation in pkts_sent, Bytes Received, Bytes"
52960,80,43936,80,allow,82011,2937,79074,91,358,34,57,1,"High deviation in pkts_sent, Bytes Received, Bytes"
50873,80,11525,80,allow,173653,9305,164348,189,141,73,116,1,"High deviation in pkts_sent, Bytes Received, Bytes"
55028,443,3475,443,allow,1403116,30089,1373027,1321,32,404,917,1,"High deviation in pkts_sent, Bytes Received, Bytes"
43208,443,45939,443,allow,4296557,96359,4200198,3781,143,838,2943,1,"High deviation in pkts_sent, Bytes Received, Bytes"
50934,80,52977,80,allow,10213447,100765,10112682,8215,121,1412,6803,1,"High deviation in pkts_sent, Bytes Received, Bytes"
60193,443,30919,443,allow,677029,102078,574951,1152,455,559,593,1,"High deviation in pkts_sent, Bytes Received, Bytes"
65462,443,5746,443,allow,92384,4519,87865,105,15,39,66,1,"High deviation in pkts_sent, Bytes Received, Bytes"
50889,80,11268,80,allow,397616,15684,381932,419,141,157,262,1,"High deviation in pkts_sent, Bytes Received, Bytes"
50887,80,30027,80,allow,256649,11414,245235,280,141,111,169,1,"High deviation in pkts_sent, Bytes Received, Bytes"
50884,80,30103,80,allow,238059,13790,224269,276,141,113,163,1,"High deviation in pkts_sent, Bytes Received, Bytes"
51697,60619,59919,60619,allow,70,70,0,1,5,1,0,1,"High deviation in NAT Destination Port, Destination Port, NAT Source Port"
50882,80,51896,80,allow,207895,10483,197412,229,141,90,139,1,"High deviation in pkts_sent, Bytes Received, Bytes"
55004,443,32429,443,allow,1334906,33112,1301794,1315,35,446,869,1,"High deviation in pkts_sent, Bytes Received, Bytes"
52959,80,37640,80,allow,122572,3630,118942,128,358,46,82,1,"High deviation in pkts_sent, Bytes Received, Bytes"
50874,80,33456,80,allow,331828,15003,316825,363,141,140,223,1,"High deviation in pkts_sent, Bytes Received, Bytes"
41776,443,6550,443,allow,32434,15588,16846,164,1128,83,81,1,"High deviation in pkts_sent, Bytes Sent, Bytes"
10151,51413,40673,51413,allow,460,150,310,2,1200,1,1,1,"High deviation in NAT Destination Port, Destination Port, Elapsed Time (sec)"
59570,443,54074,443,allow,6713,3052,3661,49,5974,15,34,1,"High deviation in pkts_sent, Elapsed Time (sec), Bytes Sent"
50881,80,32099,80,allow,128327,7366,120961,154,141,67,87,1,"High deviation in pkts_sent, Bytes Received, Bytes"
50938,80,32549,80,allow,10272889,104948,10167941,8416,121,1525,6891,1,"High deviation in pkts_sent, Bytes Received, Bytes"
50017,443,23366,443,allow,56408,47400,9008,88,138,49,39,1,"High deviation in pkts_sent, Bytes Sent, Bytes"
42298,58000,33594,58000,allow,596,256,340,10,30,5,5,1,"High deviation in pkts_sent, NAT Destination Port, Destination Port"
42298,40023,18178,40023,allow,1531,729,802,10,31,5,5,1,"High deviation in pkts_sent, NAT Destination Port, Destination Port"
48731,443,51910,443,allow,769074,31261,737813,876,165,356,520,1,"High deviation in pkts_sent, Bytes Received, Bytes"
63727,61557,39781,61557,allow,312,132,180,6,6,3,3,1,"High deviation in pkts_sent, NAT Destination Port, Destination Port"
50875,80,60669,80,allow,141059,7791,133268,168,140,72,96,1,"High deviation in pkts_sent, Bytes Received, Bytes"
48726,443,17212,443,allow,6644134,184008,6460126,6659,204,2197,4462,1,"High deviation in pkts_sent, Bytes Received, Bytes"
50931,80,59351,80,allow,7978844,97517,7881327,6752,120,1393,5359,1,"High deviation in pkts_sent, Bytes Received, Bytes"
42019,443,22698,443,allow,21620,7973,13647,112,488,57,55,1,"High deviation in pkts_sent, Bytes Sent, Bytes"
50893,80,33062,80,allow,149442,8423,141019,177,140,76,101,1,"High deviation in pkts_sent, Bytes Received, Bytes"
34531,80,18192,80,allow,467664,17895,449769,610,355,265,345,1,"High deviation in pkts_sent, Bytes Received, Bytes"
33107,443,4785,443,allow,3820081,140348,3679733,4457,136,1736,2721,1,"High deviation in pkts_sent, Bytes Received, Bytes"
50888,80,61019,80,allow,538995,15959,523036,552,140,201,351,1,"High deviation in pkts_sent, Bytes Received, Bytes"
41049,443,3441,443,allow,197239,6098,191141,213,170,75,138,1,"High deviation in pkts_sent, Bytes Received, Bytes"
50947,80,65255,80,allow,5427472,61630,5365842,4509,79,894,3615,1,"High deviation in pkts_sent, Bytes Received, Bytes"
50945,80,53857,80,allow,6920116,91852,6828264,6765,79,1277,5488,1,"High deviation in pkts_sent, Bytes Received, Bytes"
48729,443,23852,443,allow,8504354,221135,8283219,8447,196,2721,5726,1,"High deviation in pkts_sent, Bytes Received, Bytes"
42298,40031,50162,40031,allow,1341,657,684,8,30,4,4,1,"High deviation in pkts_sent, NAT Destination Port, Destination Port"
42298,40023,18406,40023,allow,1487,743,744,10,30,5,5,1,"High deviation in pkts_sent, NAT Destination Port, Destination Port"
30188,36914,20864,36914,allow,2668,1950,718,16,7827,14,2,1,"High deviation in pkts_sent, NAT Destination Port, Elapsed Time (sec)"
53105,61310,38041,61310,allow,70,70,0,1,5,1,0,1,"High deviation in NAT Destination Port, Destination Port, NAT Source Port"
41050,443,28705,443,allow,137809,4697,133112,153,170,55,98,1,"High deviation in pkts_sent, Bytes Received, Bytes"
50891,80,64394,80,allow,136656,9764,126892,162,140,70,92,1,"High deviation in pkts_sent, Bytes Received, Bytes"
56745,56518,23267,56518,allow,1556,588,968,11,16,6,5,1,"High deviation in pkts_sent, NAT Destination Port, Destination Port"
57470,39608,19893,39608,allow,330,330,0,6,1199,6,0,1,"High deviation in pkts_sent, NAT Destination Port, Destination Port"
57470,58210,46855,58210,allow,2118,858,1260,28,1261,14,14,1,"High deviation in pkts_sent, NAT Destination Port, Destination Port"
61636,25735,61636,25735,allow,3828,1516,2312,29,5271,18,11,1,"High deviation in pkts_sent, NAT Destination Port, Elapsed Time (sec)"
49950,80,40840,80,allow,51651,48866,2785,74,20,38,36,1,"High deviation in pkts_sent, Bytes Sent, Bytes"
56735,53283,31023,53283,allow,4188,1648,2540,17,19,9,8,1,"High deviation in pkts_sent, NAT Destination Port, Destination Port"
50922,80,57250,80,allow,9219616,105865,9113751,7687,120,1487,6200,1,"High deviation in pkts_sent, Bytes Received, Bytes"
37953,1935,23472,1935,allow,3623810,67493,3556317,3486,35,943,2543,1,"High deviation in pkts_sent, Bytes Received, Bytes"
61474,443,20361,443,allow,114674,4457,110217,127,48,46,81,1,"High deviation in pkts_sent, Bytes Received, Bytes"
61483,443,51261,443,allow,107901,5004,102897,127,46,53,74,1,"High deviation in pkts_sent, Bytes Received, Bytes"
44223,443,7488,443,allow,63895,4604,59291,80,276,34,46,1,"High deviation in pkts_sent, Bytes Received, Bytes"
61479,443,17440,443,allow,104543,5227,99316,130,47,57,73,1,"High deviation in pkts_sent, Bytes Received, Bytes"
60492,443,48948,443,allow,81016,8373,72643,122,339,57,65,1,"High deviation in pkts_sent, Bytes Received, Bytes"
51717,63436,12791,63436,allow,70,70,0,2,8,2,0,1,"High deviation in pkts_sent, NAT Destination Port, Destination Port"
50958,80,62860,80,allow,5730351,74236,5656115,4865,78,1088,3777,1,"High deviation in pkts_sent, Bytes Received, Bytes"
50936,80,62610,80,allow,10423067,111935,10311132,8558,119,1601,6957,1,"High deviation in pkts_sent, Bytes Received, Bytes"
50960,80,58959,80,allow,5533225,44880,5488345,4345,78,654,3691,1,"High deviation in pkts_sent, Bytes Received, Bytes"
51716,57137,62764,57137,allow,70,70,0,2,8,2,0,1,"High deviation in pkts_sent, NAT Destination Port, Destination Port"
56765,443,20044,443,allow,12038195,322404,11715791,12026,153,3435,8591,1,"High deviation in pkts_sent, Bytes Received, Bytes"
49899,7000,49899,7000,allow,758568,17631,740937,772,17,269,503,1,"High deviation in pkts_sent, Bytes Received, Bytes"
55024,443,1691,443,allow,552073,14113,537960,536,31,176,360,1,"High deviation in pkts_sent, Bytes Received, Bytes"
6881,41019,41697,41019,allow,150,150,0,1,1200,1,0,1,"High deviation in NAT Destination Port, Destination Port, Elapsed Time (sec)"
61431,443,56520,443,allow,352310,324883,27427,389,300,270,119,1,"High deviation in pkts_sent, Bytes Sent, Bytes"
14641,443,14641,443,allow,254281,66535,187746,336,317,183,153,1,"High deviation in pkts_sent, Bytes Sent, Bytes"
53510,58706,37396,58706,allow,492,306,186,8,16,5,3,1,"High deviation in pkts_sent, NAT Destination Port, Destination Port"
63698,59517,14181,59517,allow,504,382,122,8,15,6,2,1,"High deviation in pkts_sent, NAT Destination Port, Destination Port"
50871,80,63200,80,allow,94083,6192,87891,121,139,57,64,1,"High deviation in pkts_sent, Bytes Received, Bytes"
63692,42635,61565,42635,allow,562,380,182,8,15,5,3,1,"High deviation in pkts_sent, NAT Destination Port, Destination Port"
6881,10385,61159,10385,allow,118,118,0,1,1199,1,0,1,"High deviation in NAT Destination Port, Elapsed Time (sec), Destination Port"
6881,13234,11039,13234,allow,324,150,174,2,1201,1,1,1,"High deviation in NAT Destination Port, Elapsed Time (sec), Destination Port"
50932,80,42211,80,allow,11381441,121813,11259628,9309,119,1741,7568,1,"High deviation in pkts_sent, Bytes Received, Bytes"
50946,80,36199,80,allow,5870176,83236,5786940,5053,78,1161,3892,1,"High deviation in pkts_sent, Bytes Received, Bytes"
53506,50144,41476,50144,allow,492,306,186,8,15,5,3,1,"High deviation in pkts_sent, NAT Destination Port, Destination Port"
51000,443,31109,443,allow,41713,34380,7333,67,333,38,29,1,"High deviation in pkts_sent, Bytes Sent, Bytes"
50964,80,13485,80,allow,4680740,67312,4613428,4675,77,985,3690,1,"High deviation in pkts_sent, Bytes Received, Bytes"
